Date,Type,Description,Amount,Category,Payment Method,Status,Reference,Receipt URL,year,month,quarter,day_of_month,day_of_week,day_of_year,week_of_year,is_weekend,is_month_start,is_month_end,is_quarter_start,is_quarter_end,days_since_epoch,days_from_start,days_to_end,month_sin,month_cos,day_of_week_sin,day_of_week_cos,day_of_year_sin,day_of_year_cos,is_business_day,business_day_of_month,season,is_spring,is_summer,is_fall,is_winter,amount_abs,amount_sign,is_income,is_expense,amount_log,amount_log_signed,amount_sqrt,amount_sqrt_signed,amount_squared,amount_cubed,amount_category,amount_percentile,amount_quartile,amount_rolling_mean_7d,amount_rolling_std_7d,amount_rolling_sum_7d,amount_rolling_min_7d,amount_rolling_max_7d,amount_rolling_volatility_7d,amount_rolling_mean_14d,amount_rolling_std_14d,amount_rolling_sum_14d,amount_rolling_min_14d,amount_rolling_max_14d,amount_rolling_volatility_14d,amount_rolling_mean_30d,amount_rolling_std_30d,amount_rolling_sum_30d,amount_rolling_min_30d,amount_rolling_max_30d,amount_rolling_volatility_30d,amount_expanding_mean,amount_expanding_std,amount_expanding_count,amount_zscore,amount_abs_zscore,amount_distance_from_mean,amount_distance_from_mean_abs,amount_cumulative_sum,amount_cumulative_abs_sum,running_balance,category_encoded,payment_method_encoded,status_encoded,type_encoded,category_frequency,category_frequency_pct,payment_method_frequency,payment_method_frequency_pct,status_frequency,status_frequency_pct,type_frequency,type_frequency_pct,is_pending,is_paid,is_received,category_is_unknown,category_is_software,category_is_fuel,category_is_meals_entertainment,category_is_office_supplies,category_is_travel,category_is_telephone,category_is_computer_equipment,category_is_supplies,category_is_training,payment_is_credit_card,payment_is_unknown,payment_is_bank_transfer,payment_is_other,payment_is_credit_car,amount_lag_1,amount_abs_lag_1,amount_lag_2,amount_abs_lag_2,amount_lag_3,amount_abs_lag_3,amount_lag_7,amount_abs_lag_7,days_since_last,days_since_last_capped,transaction_count_last_7d,transaction_count_last_30d,spending_velocity_7d,spending_velocity_30d,category_streak,payment_method_streak,days_since_same_category,days_since_same_payment,days_since_same_amount_range,category_running_total,category_running_count,amount_trend_3,amount_trend_7,amount_x_day_of_week,amount_x_month,amount_x_is_weekend,category_encoded_x_month,category_encoded_x_day_of_week
2024-08-06,Expense,Office Equipment Repair,-175.0,repairs,credit_card,paid,TechRepair Pro,https://tmsappstorage.blob.core.windows.net/receipts/00998877-6655-4433-2211-009988776655.png,2024,8,3,6,1,219,32,0,0,0,0,0,19941,0,122,-0.8660254037844384,-0.5000000000000004,0.7818314824680298,0.6234898018587336,-0.5856957398073508,-0.8105309990194823,1,4,Summer,0,1,0,0,175.0,-1.0,0,1,5.170483995038151,-5.170483995038151,13.228756555322953,-13.228756555322953,30625.0,-5359375.0,small,0.5787401574803149,Q3,-175.0,0.0,-175.0,-175.0,-175.0,0.0,-175.0,0.0,-175.0,-175.0,-175.0,0.0,-175.0,0.0,-175.0,-175.0,-175.0,0.0,-175.0,0.0,1.0,-0.49245020265847794,0.49245020265847794,0.0,0.0,-175.0,175.0,-175.0,15,3,0,0,3,2.3622047244094486,88,69.29133858267717,99,77.95275590551181,100,78.74015748031496,0,1,0,0,0,0,0,0,0,0,0,0,0,1,0,0,0,0,0.0,0.0,0.0,0.0,0.0,0.0,0.0,0.0,0.0,0.0,7.0,30.0,-175.0,-175.0,1,1,-1,-1,-1,-175.0,1,-7.1125000000000504,8.616785714285708,175.0,1400.0,0.0,120,15
2024-08-07,Expense,Fuel for Client Visits,-89.23,fuel,credit_card,paid,Exxon,https://tmsappstorage.blob.core.windows.net/receipts/33221100-9988-7766-5544-332211009988.png,2024,8,3,7,2,220,32,0,0,0,0,0,19942,1,121,-0.8660254037844384,-0.5000000000000004,0.9749279121818236,-0.22252093395631434,-0.5995514915196489,-0.8003361849976323,1,5,Summer,0,1,0,0,89.23,-1.0,0,1,4.50236196600641,-4.50236196600641,9.446163242290492,-9.446163242290492,7961.992900000001,-710448.6264670001,small,0.3661417322834646,Q2,-132.115,60.64854862237018,-264.23,-175.0,-89.23,0.4590587641249682,-132.115,60.64854862237018,-264.23,-175.0,-89.23,0.4590587641249682,-132.115,60.64854862237018,-264.23,-175.0,-89.23,0.4590587641249682,-132.115,60.64854862237018,2.0,-0.4167077229156639,0.4167077229156639,42.885000000000005,42.885000000000005,-264.23,264.23,-264.23,5,3,0,0,9,7.086614173228346,88,69.29133858267717,99,77.95275590551181,100,78.74015748031496,0,1,0,0,0,1,0,0,0,0,0,0,0,1,0,0,0,0,-175.0,175.0,0.0,0.0,0.0,0.0,0.0,0.0,1.0,1.0,7.0,30.0,-264.23,-264.23,1,2,-1,1,1,-89.23,1,85.76999999999998,85.76999999999998,178.46,713.84,0.0,40,10
2024-08-08,Expense,Software License Renewal,-399.0,software,credit_card,paid,IntelliJ IDEA,https://tmsappstorage.blob.core.windows.net/receipts/66554433-2211-0099-8877-665544332211.png,2024,8,3,8,3,221,32,0,0,0,0,0,19943,2,120,-0.8660254037844384,-0.5000000000000004,0.43388373911755823,-0.900968867902419,-0.6132298262997502,-0.7899045386224707,1,6,Summer,0,1,0,0,399.0,-1.0,0,1,5.991464547107982,-5.991464547107982,19.974984355438178,-19.974984355438178,159201.0,-63521199.0,medium,0.7401574803149606,Q3,-221.07666666666668,159.94266983307904,-663.23,-399.0,-89.23,0.7234715098822989,-221.07666666666668,159.94266983307904,-663.23,-399.0,-89.23,0.7234715098822989,-221.07666666666668,159.94266983307904,-663.23,-399.0,-89.23,0.7234715098822989,-221.07666666666668,159.94266983307904,3.0,-0.6902619720695815,0.6902619720695815,-177.92333333333332,177.92333333333332,-663.23,663.23,-663.23,16,3,0,0,15,11.811023622047244,88,69.29133858267717,99,77.95275590551181,100,78.74015748031496,0,1,0,0,1,0,0,0,0,0,0,0,0,1,0,0,0,0,-89.23,89.23,-175.0,175.0,0.0,0.0,0.0,0.0,1.0,1.0,7.0,30.0,-663.23,-663.23,1,3,-1,1,-1,-399.0,1,-112.00000000000006,-112.00000000000006,1197.0,3192.0,0.0,128,48
2024-08-09,Income,Custom Integration Project,3275.0,Unknown,Unknown,received,Enterprise Client,Unknown,2024,8,3,9,4,222,32,0,0,0,0,0,19944,3,119,-0.8660254037844384,-0.5000000000000004,-0.433883739117558,-0.9009688679024191,-0.6267266965083301,-0.7792391467859886,1,7,Summer,0,1,0,0,3275.0,1.0,1,0,8.09437844497296,8.09437844497296,57.227615711297986,57.227615711297986,10725625.0,35126421875.0,xlarge,0.968503937007874,Q4,652.9425,1752.909710517059,2611.77,-399.0,3275.0,2.6846310517649856,652.9425,1752.909710517059,2611.77,-399.0,3275.0,2.6846310517649856,652.9425,1752.909710517059,2611.77,-399.0,3275.0,2.6846310517649856,652.9425,1752.909710517059,4.0,2.5542042815750374,2.5542042815750374,2622.0575,2622.0575,2611.77,3938.23,2611.77,0,0,1,1,27,21.25984251968504,27,21.25984251968504,27,21.25984251968504,27,21.25984251968504,0,0,1,1,0,0,0,0,0,0,0,0,0,0,1,0,0,0,-399.0,399.0,-89.23,89.23,-175.0,175.0,0.0,0.0,1.0,1.0,7.0,30.0,2611.77,2611.77,1,1,-1,-1,-1,3275.0,1,1682.1150000000002,1004.0229999999999,13100.0,26200.0,0.0,0,0
2024-08-10,Expense,Office Supply Restocking,-156.78,office_supplies,credit_card,paid,OfficeMax,https://tmsappstorage.blob.core.windows.net/receipts/99887766-5544-3322-1100-998877665544.png,2024,8,3,10,5,223,32,1,0,0,0,0,19945,4,118,-0.8660254037844384,-0.5000000000000004,-0.9749279121818236,-0.2225209339563146,-0.6400381082043503,-0.7683431655492202,0,8,Summer,0,1,0,0,156.78,-1.0,0,1,5.061201657666944,-5.061201657666944,12.521182052825523,-12.521182052825523,24579.9684,-3853647.445752,small,0.547244094488189,Q3,490.99799999999993,1560.6567352624343,2454.99,-399.0,3275.0,3.178539902937353,490.99799999999993,1560.6567352624343,2454.99,-399.0,3275.0,3.178539902937353,490.99799999999993,1560.6567352624343,2454.99,-399.0,3275.0,3.178539902937353,490.99799999999993,1560.6567352624343,5.0,-0.47636033462869976,0.47636033462869976,-647.7779999999999,647.7779999999999,2454.99,4095.01,2454.99,11,3,0,0,6,4.724409448818897,88,69.29133858267717,99,77.95275590551181,100,78.74015748031496,0,1,0,0,0,0,0,1,0,0,0,0,0,1,0,0,0,0,3275.0,3275.0,-399.0,399.0,-89.23,89.23,0.0,0.0,1.0,1.0,7.0,30.0,2454.99,2454.99,1,1,-1,2,3,-156.78,1,121.11000000000013,340.0670000000001,783.9,1254.24,156.78,88,55
2024-08-11,Expense,Parking for Conference,-35.0,travel,credit_card,paid,Conference Center,https://tmsappstorage.blob.core.windows.net/receipts/22110099-8877-6655-4433-221100998877.png,2024,8,3,11,6,224,32,1,0,0,0,0,19946,5,117,-0.8660254037844384,-0.5000000000000004,-0.7818314824680299,0.6234898018587334,-0.65316012232693,-0.7572198192083127,0,8,Summer,0,1,0,0,35.0,-1.0,0,1,3.58351893845611,-3.58351893845611,5.916079783099616,-5.916079783099616,1225.0,-42875.0,micro,0.13385826771653545,Q1,403.33166666666665,1412.3143673618374,2419.99,-399.0,3275.0,3.501620338997692,403.33166666666665,1412.3143673618374,2419.99,-399.0,3275.0,3.501620338997692,403.33166666666665,1412.3143673618374,2419.99,-399.0,3275.0,3.501620338997692,403.33166666666665,1412.3143673618374,6.0,-0.36881784677653817,0.36881784677653817,-438.33166666666665,438.33166666666665,2419.99,4130.01,2419.99,20,3,0,0,6,4.724409448818897,88,69.29133858267717,99,77.95275590551181,100,78.74015748031496,0,1,0,0,0,0,0,0,1,0,0,0,0,1,0,0,0,0,-156.78,156.78,3275.0,3275.0,-399.0,399.0,0.0,0.0,1.0,1.0,7.0,30.0,2419.99,2419.99,1,2,-1,1,-1,-35.0,1,-1655.0000000000002,119.18142857142853,210.0,280.0,35.0,160,120
2024-08-12,Expense,Business Lunch Meeting,-78.9,meals_entertainment,credit_card,paid,Red Lobster,https://tmsappstorage.blob.core.windows.net/receipts/55443322-1100-9988-7766-554433221100.png,2024,8,3,12,0,225,33,0,0,0,0,0,19947,6,116,-0.8660254037844384,-0.5000000000000004,0.0,1.0,-0.666088855860977,-0.7458723993404063,1,8,Summer,0,1,0,0,78.9,-1.0,0,1,4.380775852772229,-4.380775852772229,8.882567196480982,-8.882567196480982,6225.210000000001,-491169.06900000013,small,0.3228346456692913,Q2,334.4414285714286,1302.080750650391,2341.09,-399.0,3275.0,3.8932998110080077,334.4414285714286,1302.080750650391,2341.09,-399.0,3275.0,3.8932998110080077,334.4414285714286,1302.080750650391,2341.09,-399.0,3275.0,3.8932998110080077,334.4414285714286,1302.080750650391,7.0,-0.4075854212280893,0.4075854212280893,-413.34142857142865,413.34142857142865,2341.0899999999997,4208.91,2341.0899999999997,10,3,0,0,9,7.086614173228346,88,69.29133858267717,99,77.95275590551181,100,78.74015748031496,0,1,0,0,0,0,1,0,0,0,0,0,0,1,0,0,0,0,-35.0,35.0,-156.78,156.78,3275.0,3275.0,0.0,0.0,1.0,1.0,7.0,30.0,2341.09,2341.09,1,3,-1,1,2,-78.9,1,38.93999999999996,22.8207142857143,0.0,631.2,0.0,80,0
2024-08-13,Expense,Project Collaboration Tool,-29.99,software,credit_card,paid,Slack,https://tmsappstorage.blob.core.windows.net/receipts/88776655-4433-2211-0099-887766554433.png,2024,8,3,13,1,226,33,0,0,0,0,0,19948,7,115,-0.8660254037844384,-0.5000000000000004,0.7818314824680298,0.6234898018587336,-0.6788204829862355,-0.734304263829602,1,9,Summer,0,1,0,0,29.99,-1.0,0,1,3.433664571799657,-3.433664571799657,5.476312628037227,-5.476312628037227,899.4001,-26973.008998999994,micro,0.1141732283464567,Q1,355.15714285714284,1293.751740645712,2486.1,-399.0,3275.0,3.6427586116889845,288.8875,1212.3586615796264,2311.1,-399.0,3275.0,4.196646312421363,288.8875,1212.3586615796264,2311.1,-399.0,3275.0,4.196646312421363,288.8875,1212.3586615796264,8.0,-0.36439357461247734,0.36439357461247734,-318.8775,318.8775,2311.1,4238.9,2311.1,16,3,0,0,15,11.811023622047244,88,69.29133858267717,99,77.95275590551181,100,78.74015748031496,0,1,0,0,1,0,0,0,0,0,0,0,0,1,0,0,0,0,-78.9,78.9,-35.0,35.0,-156.78,156.78,-175.0,175.0,1.0,1.0,7.0,30.0,2486.1,2311.1,1,4,5,1,2,-428.99,2,2.5050000000000066,-89.00285714285711,29.99,239.92,0.0,128,16
2024-08-14,Income,Consulting Retainer August,2000.0,Unknown,Unknown,received,MainClient,Unknown,2024,8,3,14,2,227,33,0,0,0,0,0,19949,8,114,-0.8660254037844384,-0.5000000000000004,0.9749279121818236,-0.22252093395631434,-0.6913512362094071,-0.722518835873311,1,10,Summer,0,1,0,0,2000.0,1.0,1,0,7.601402334583733,7.601402334583733,44.721359549995796,44.721359549995796,4000000.0,8000000000.0,xlarge,0.8740157480314961,Q4,653.6185714285714,1409.919319209774,4575.33,-399.0,3275.0,2.157098009207733,479.0111111111112,1269.4131405047417,4311.1,-399.0,3275.0,2.6500703450494476,479.0111111111112,1269.4131405047417,4311.1,-399.0,3275.0,2.6500703450494476,479.0111111111112,1269.4131405047417,9.0,1.428266754793086,1.428266754793086,1520.9888888888888,1520.9888888888888,4311.1,6238.9,4311.1,0,0,1,1,27,21.25984251968504,27,21.25984251968504,27,21.25984251968504,27,21.25984251968504,0,0,1,1,0,0,0,0,0,0,0,0,0,0,1,0,0,0,-29.99,29.99,-78.9,78.9,-35.0,35.0,-89.23,89.23,1.0,1.0,7.0,30.0,4575.33,4311.1,1,1,5,5,5,5275.0,2,1039.4500000000003,23.746428571428684,4000.0,16000.0,0.0,0,0
2024-08-15,Expense,Vehicle Insurance Renewal,-312.45,vehicle,bank_transfer,paid,State Farm,Unknown,2024,8,3,15,3,228,33,0,0,0,0,0,19950,9,113,-0.8660254037844384,-0.5000000000000004,0.43388373911755823,-0.900968867902419,-0.7036774074790128,-0.7105196029692745,1,11,Summer,0,1,0,0,312.45,-1.0,0,1,5.747639857719977,-5.747639857719977,17.676255259528247,-17.676255259528247,97625.00249999999,-30502932.031124998,medium,0.7086614173228346,Q3,665.9828571428571,1399.4908252017267,4661.88,-312.45,3275.0,2.1013916652535216,399.865,1222.7040793826152,3998.65,-399.0,3275.0,3.0577922033251603,399.865,1222.7040793826152,3998.65,-399.0,3275.0,3.0577922033251603,399.865,1222.7040793826152,10.0,-0.6138306834868539,0.6138306834868539,-712.315,712.315,3998.6500000000005,6551.349999999999,3998.6500000000005,21,1,0,0,2,1.574803149606299,10,7.874015748031496,99,77.95275590551181,100,78.74015748031496,0,1,0,0,0,0,0,0,0,0,0,0,0,0,0,1,0,0,2000.0,2000.0,-29.99,29.99,-78.9,78.9,-399.0,399.0,1.0,1.0,7.0,30.0,4661.88,3998.65,1,1,-1,-1,7,-312.45,1,-141.23000000000005,-230.13500000000002,937.3499999999999,2499.6,0.0,168,63
2024-08-16,Expense,Professional Association Dues,-195.0,professional_fees,credit_card,paid,IEEE,https://tmsappstorage.blob.core.windows.net/receipts/11009988-7766-5544-3322-110099887766.png,2024,8,3,16,4,229,33,0,0,0,0,0,19951,10,112,-0.8660254037844384,-0.5000000000000004,-0.433883739117558,-0.9009688679024191,-0.7157953492826642,-0.6983101158835584,1,12,Summer,0,1,0,0,195.0,-1.0,0,1,5.278114659230518,-5.278114659230518,13.96424004376894,-13.96424004376894,38025.0,-7414875.0,small,0.6259842519685039,Q3,170.26857142857142,812.9821519243943,1191.8799999999999,-312.45,2000.0,4.774704721507836,345.78636363636366,1173.7436803601774,3803.65,-399.0,3275.0,3.394418646290261,345.78636363636366,1173.7436803601774,3803.65,-399.0,3275.0,3.394418646290261,345.78636363636366,1173.7436803601774,11.0,-0.5101119677844693,0.5101119677844693,-540.7863636363636,540.7863636363636,3803.6500000000005,6746.349999999999,3803.6500000000005,13,3,0,0,3,2.3622047244094486,88,69.29133858267717,99,77.95275590551181,100,78.74015748031496,0,1,0,0,0,0,0,0,0,0,0,0,0,1,0,0,0,0,-312.45,312.45,2000.0,2000.0,-29.99,29.99,3275.0,3275.0,1.0,1.0,7.0,30.0,1191.8799999999999,3803.65,1,1,-1,3,4,-195.0,1,-1097.5,50.333571428571425,780.0,1560.0,0.0,104,52
2024-08-17,Expense,Office Cleaning Supplies,-45.67,supplies,credit_card,paid,CVS Pharmacy,https://tmsappstorage.blob.core.windows.net/receipts/44332211-0099-8877-6655-443322110099.png,2024,8,3,17,5,230,33,1,0,0,0,0,19952,11,111,-0.8660254037844384,-0.5000000000000004,-0.9749279121818236,-0.2225209339563146,-0.7277014757264236,-0.6858939875998223,0,13,Summer,0,1,0,0,45.67,-1.0,0,1,3.8431015599617244,-3.8431015599617244,6.757958271549182,-6.757958271549182,2085.7489,-95256.15226300001,micro,0.18503937007874016,Q1,186.14142857142858,806.5921048342541,1302.99,-312.45,2000.0,4.3332218465527585,313.165,1124.8115202153162,3757.98,-399.0,3275.0,3.5917536130005465,313.165,1124.8115202153162,3757.98,-399.0,3275.0,3.5917536130005465,313.165,1124.8115202153162,12.0,-0.3782403984712546,0.3782403984712546,-358.83500000000004,358.83500000000004,3757.9800000000005,6792.0199999999995,3757.9800000000005,17,3,0,0,5,3.937007874015748,88,69.29133858267717,99,77.95275590551181,100,78.74015748031496,0,1,0,0,0,0,0,0,0,0,0,1,0,1,0,0,0,0,-195.0,195.0,-312.45,312.45,2000.0,2000.0,-156.78,156.78,1.0,1.0,7.0,30.0,1302.99,3757.98,1,2,-1,1,4,-45.67,1,133.38999999999996,-19.523928571428566,228.35000000000002,365.36,45.67,136,85
2024-08-18,Expense,Hardware Testing Tools,-234.99,hardware,credit_card,paid,Newegg,https://tmsappstorage.blob.core.windows.net/receipts/77665544-3322-1100-9988-776655443322.png,2024,8,3,18,6,231,33,1,0,0,0,0,19953,12,110,-0.8660254037844384,-0.5000000000000004,-0.7818314824680299,0.6234898018587334,-0.7393922635959241,-0.673274892250183,0,13,Summer,0,1,0,0,234.99,-1.0,0,1,5.463789431246498,-5.463789431246498,15.329383549249462,-15.329383549249462,55220.30010000001,-12976218.320499001,medium,0.6456692913385826,Q3,157.57142857142858,819.1743176196499,1103.0,-312.45,2000.0,5.198749069209019,270.99923076923073,1087.6032917571672,3522.99,-399.0,3275.0,4.013307671280127,270.99923076923073,1087.6032917571672,3522.99,-399.0,3275.0,4.013307671280127,270.99923076923073,1087.6032917571672,13.0,-0.5454266671538891,0.5454266671538891,-505.98923076923074,505.98923076923074,3522.9900000000007,7027.009999999999,3522.9900000000007,7,3,0,0,2,1.574803149606299,88,69.29133858267717,99,77.95275590551181,100,78.74015748031496,0,1,0,0,0,0,0,0,0,0,0,0,0,1,0,0,0,0,-45.67,45.67,-195.0,195.0,-312.45,312.45,-35.0,35.0,1.0,1.0,7.0,30.0,1103.0,3522.99,1,3,-1,1,3,-234.99,1,-19.99500000000005,-96.23678571428572,1409.94,1879.92,234.99,56,42
2024-08-19,Income,Database Design & Setup,2100.0,Unknown,Unknown,received,New Startup,Unknown,2024,8,3,19,0,232,34,0,0,0,0,0,19954,13,109,-0.8660254037844384,-0.5000000000000004,0.0,1.0,-0.7508642533989489,-0.6604565640279754,1,13,Summer,0,1,0,0,2100.0,1.0,1,0,7.650168700845001,7.650168700845001,45.8257569495584,45.8257569495584,4410000.0,9261000000.0,xlarge,0.8937007874015748,Q4,468.84285714285716,1085.1390140394346,3281.9,-312.45,2100.0,2.3145047375837295,401.64214285714286,1153.6186835024057,5622.99,-399.0,3275.0,2.8722550758642074,401.64214285714286,1153.6186835024057,5622.99,-399.0,3275.0,2.8722550758642074,401.64214285714286,1153.6186835024057,14.0,1.516575580423043,1.516575580423043,1698.357857142857,1698.357857142857,5622.990000000001,9127.009999999998,5622.990000000001,0,0,1,1,27,21.25984251968504,27,21.25984251968504,27,21.25984251968504,27,21.25984251968504,0,0,1,1,0,0,0,0,0,0,0,0,0,0,1,0,0,0,-234.99,234.99,-45.67,45.67,-195.0,195.0,-78.9,78.9,1.0,1.0,7.0,30.0,3281.9,5622.99,1,1,5,5,5,7375.0,3,1072.8350000000003,78.09892857142853,0.0,16800.0,0.0,0,0
2024-08-20,Expense,Fuel Stop,-67.45,fuel,credit_card,paid,Chevron,https://tmsappstorage.blob.core.windows.net/receipts/00998877-6655-4433-2211-009988776655.png,2024,8,3,20,1,233,34,0,0,0,0,0,19955,14,108,-0.8660254037844384,-0.5000000000000004,0.7818314824680298,0.6234898018587336,-0.7621140503891487,-0.6474427960827475,1,14,Summer,0,1,0,0,67.45,-1.0,0,1,4.226103551734458,-4.226103551734458,8.212794895770866,-8.212794895770866,4549.5025000000005,-306863.943625,small,0.2559055118110236,Q1,463.49142857142857,1088.0973779557994,3244.44,-312.45,2100.0,2.347610572453365,409.32428571428574,1149.8352367970897,5730.54,-399.0,3275.0,2.8091058286233506,370.3693333333333,1118.2335074090656,5555.54,-399.0,3275.0,3.019238923873464,370.3693333333333,1118.2335074090656,15.0,-0.3974740606934592,0.3974740606934592,-437.8193333333333,437.8193333333333,5555.540000000001,9194.46,5555.540000000001,5,3,0,0,9,7.086614173228346,88,69.29133858267717,99,77.95275590551181,100,78.74015748031496,0,1,0,0,0,1,0,0,0,0,0,0,0,1,0,0,0,0,2100.0,2100.0,-234.99,234.99,-45.67,45.67,-29.99,29.99,1.0,1.0,7.0,30.0,3244.44,5555.54,1,1,13,2,4,-156.68,2,83.76999999999991,-50.62285714285716,67.45,539.6,0.0,40,5
2024-08-21,Expense,Equipment Calibration,-125.0,maintenance,credit_card,paid,TechCal Services,https://tmsappstorage.blob.core.windows.net/receipts/33221100-9988-7766-5544-332211009988.png,2024,8,3,21,2,234,34,0,0,0,0,0,19956,15,107,-0.8660254037844384,-0.5000000000000004,0.9749279121818236,-0.22252093395631434,-0.7731383255706026,-0.6342374393978054,1,15,Summer,0,1,0,0,125.0,-1.0,0,1,4.836281906951478,-4.836281906951478,11.180339887498949,-11.180339887498949,15625.0,-1953125.0,small,0.4645669291338583,Q2,159.92000000000002,860.6305546129148,1119.44,-312.45,2100.0,5.381631782221828,406.7692857142857,1151.0673510767451,5694.7699999999995,-399.0,3275.0,2.8297794142826547,339.40875,1087.3913840678524,5430.54,-399.0,3275.0,3.2037812344786407,339.40875,1087.3913840678524,16.0,-0.44829578984349944,0.44829578984349944,-464.40875,464.40875,5430.540000000001,9319.46,5430.540000000001,9,3,0,0,3,2.3622047244094486,88,69.29133858267717,99,77.95275590551181,100,78.74015748031496,0,1,0,0,0,0,0,0,0,0,0,0,0,1,0,0,0,0,-67.45,67.45,2100.0,2100.0,-234.99,234.99,2000.0,2000.0,1.0,1.0,7.0,30.0,1119.44,5430.54,1,2,-1,1,1,-125.0,1,-1112.4999999999998,105.8257142857143,250.0,1000.0,0.0,72,18
2024-08-22,Expense,Office Phone System,-89.99,telephone,credit_card,paid,Vonage,https://tmsappstorage.blob.core.windows.net/receipts/66554433-2211-0099-8877-665544332211.png,2024,8,3,22,3,235,34,0,0,0,0,0,19957,16,106,-0.8660254037844384,-0.5000000000000004,0.43388373911755823,-0.900968867902419,-0.7839338166829201,-0.620844401650647,1,16,Summer,0,1,0,0,89.99,-1.0,0,1,4.5107496103686,-4.5107496103686,9.486305919587455,-9.486305919587455,8098.200099999999,-728757.0269989999,small,0.40551181102362205,Q2,191.70000000000002,844.2315560713582,1341.9,-234.99,2100.0,4.403920480288775,428.8414285714286,1137.3083520911396,6003.780000000001,-312.45,3275.0,2.652048697533213,314.15000000000003,1058.0004000176464,5340.55,-399.0,3275.0,3.3678191947084075,314.15000000000003,1058.0004000176464,17.0,-0.41737886999045154,0.41737886999045154,-404.14000000000004,404.14000000000004,5340.550000000001,9409.449999999999,5340.550000000001,18,3,0,0,6,4.724409448818897,88,69.29133858267717,99,77.95275590551181,100,78.74015748031496,0,1,0,0,0,0,0,0,0,1,0,0,0,1,0,0,0,0,-125.0,125.0,-67.45,67.45,2100.0,2100.0,-312.45,312.45,1.0,1.0,7.0,30.0,1341.9,5340.55,1,3,-1,1,1,-89.99,1,-11.27000000000001,11.568214285714303,269.96999999999997,719.92,0.0,144,54
2024-08-23,Expense,Backup Service Subscription,-15.99,software,credit_card,paid,Backblaze,https://tmsappstorage.blob.core.windows.net/receipts/99887766-5544-3322-1100-998877665544.png,2024,8,3,23,4,236,34,0,0,0,0,0,19958,17,105,-0.8660254037844384,-0.5000000000000004,-0.433883739117558,-0.9009688679024191,-0.7944973291665992,-0.6072676460566135,1,17,Summer,0,1,0,0,15.99,-1.0,0,1,2.8326249356838407,-2.8326249356838407,3.998749804626441,-3.998749804626441,255.6801,-4088.324799,micro,0.051181102362204724,Q1,217.27285714285716,833.2048538167608,1520.91,-234.99,2100.0,3.834831763034844,193.7707142857143,791.2383068375435,2712.79,-312.45,2100.0,4.083374052442544,295.8088888888889,1029.3565902508276,5324.5599999999995,-399.0,3275.0,3.4798027676493266,295.8088888888889,1029.3565902508276,18.0,-0.3520303390242834,0.3520303390242834,-311.7988888888889,311.7988888888889,5324.560000000001,9425.439999999999,5324.560000000001,16,3,0,0,15,11.811023622047244,88,69.29133858267717,99,77.95275590551181,100,78.74015748031496,0,1,0,0,1,0,0,0,0,0,0,0,0,1,0,0,0,0,-89.99,89.99,-125.0,125.0,-67.45,67.45,-195.0,195.0,1.0,1.0,7.0,30.0,1520.91,5324.5599999999995,1,4,10,1,6,-444.98,3,54.50500000000001,-65.92714285714287,63.96,127.92,0.0,128,64
2024-08-24,Income,Performance Optimization,2750.0,Unknown,Unknown,received,HighTraffic Site,Unknown,2024,8,3,24,5,237,34,1,0,0,0,0,19959,18,104,-0.8660254037844384,-0.5000000000000004,-0.9749279121818236,-0.2225209339563146,-0.8048257371083452,-0.593511190196115,0,18,Summer,0,1,0,0,2750.0,1.0,1,0,7.919719760924575,7.919719760924575,52.44044240850758,52.44044240850758,7562500.0,20796875000.0,xlarge,0.9330708661417323,Q4,616.6542857142857,1251.2934059185473,4316.58,-234.99,2750.0,2.0291651820260093,401.3978571428571,1035.7698990173635,5619.57,-312.45,2750.0,2.5804071461416247,424.97684210526313,1147.9166151339498,8074.5599999999995,-399.0,3275.0,2.7011274530804212,424.97684210526313,1147.9166151339498,19.0,2.0905829470177633,2.0905829470177633,2325.023157894737,2325.023157894737,8074.560000000001,12175.439999999999,8074.560000000001,0,0,1,1,27,21.25984251968504,27,21.25984251968504,27,21.25984251968504,27,21.25984251968504,0,0,1,1,0,0,0,0,0,0,0,0,0,0,1,0,0,0,-15.99,15.99,-89.99,89.99,-125.0,125.0,-45.67,45.67,1.0,1.0,7.0,30.0,4316.58,8074.5599999999995,1,1,5,5,5,10125.0,4,1419.9950000000003,167.87321428571434,13750.0,22000.0,2750.0,0,0
2024-08-25,Expense,Client Entertainment Dinner,-156.78,entertainment,credit_card,paid,Morton's,https://tmsappstorage.blob.core.windows.net/receipts/22110099-8877-6655-4433-221100998877.png,2024,8,3,25,6,238,34,1,0,0,0,0,19960,19,103,-0.8660254037844384,-0.5000000000000004,-0.7818314824680299,0.6234898018587334,-0.8149159841660791,-0.5795791048257612,0,18,Summer,0,1,0,0,156.78,-1.0,0,1,5.061201657666944,-5.061201657666944,12.521182052825523,-12.521182052825523,24579.9684,-3853647.445752,small,0.547244094488189,Q3,627.8271428571428,1242.7415863017577,4394.79,-156.78,2750.0,1.9794327155819287,392.69928571428574,1040.2185719539484,5497.79,-312.45,2750.0,2.648893465802673,395.889,1124.8472403322853,7917.78,-399.0,3275.0,2.8413197647125465,395.889,1124.8472403322853,20.0,-0.47636033462869976,0.47636033462869976,-552.669,552.669,7917.780000000002,12332.22,7917.780000000002,3,3,0,0,4,3.149606299212598,88,69.29133858267717,99,77.95275590551181,100,78.74015748031496,0,1,0,0,0,0,0,0,0,0,0,0,0,1,0,0,0,0,2750.0,2750.0,-15.99,15.99,-89.99,89.99,-234.99,234.99,1.0,1.0,7.0,30.0,4394.79,7917.78,1,1,-1,2,3,-156.78,1,-70.39499999999995,-36.65821428571431,940.6800000000001,1254.24,156.78,24,18
2024-08-26,Expense,Business Travel Hotel,-189.0,travel,credit_card,paid,Marriott,https://tmsappstorage.blob.core.windows.net/receipts/55443322-1100-9988-7766-554433221100.png,2024,8,3,26,0,239,35,0,0,0,0,0,19961,20,102,-0.8660254037844384,-0.5000000000000004,0.0,1.0,-0.8247650844733614,-0.5654755126737576,1,18,Summer,0,1,0,0,189.0,-1.0,0,1,5.247024072160486,-5.247024072160486,13.74772708486752,-13.74772708486752,35721.0,-6751269.0,small,0.6023622047244095,Q3,300.82714285714286,1081.4997736124635,2105.79,-189.0,2750.0,3.5950870767204917,384.835,1044.46574939425,5387.69,-312.45,2750.0,2.7140612194687335,368.03714285714284,1103.769674004241,7728.78,-399.0,3275.0,2.9990714128347635,368.03714285714284,1103.769674004241,21.0,-0.5048134382466719,0.5048134382466719,-557.0371428571428,557.0371428571428,7728.780000000002,12521.22,7728.780000000002,20,3,0,0,6,4.724409448818897,88,69.29133858267717,99,77.95275590551181,100,78.74015748031496,0,1,0,0,0,0,0,0,1,0,0,0,0,1,0,0,0,0,-156.78,156.78,2750.0,2750.0,-15.99,15.99,2100.0,2100.0,1.0,1.0,7.0,30.0,2105.79,7728.78,1,2,15,1,1,-224.0,2,-1469.4999999999998,86.13499999999998,0.0,1512.0,0.0,160,0
2024-08-27,Expense,Office Desk Organizer,-34.99,home_office,credit_card,paid,Target,https://tmsappstorage.blob.core.windows.net/receipts/88776655-4433-2211-0099-887766554433.png,2024,8,3,27,1,240,35,0,0,0,0,0,19962,21,101,-0.8660254037844384,-0.5000000000000004,0.7818314824680298,0.6234898018587336,-0.8343701235229537,-0.5512045872199277,1,19,Summer,0,1,0,0,34.99,-1.0,0,1,3.5832411220909393,-3.5832411220909393,5.915234568468101,-5.915234568468101,1224.3001000000002,-42838.26049900001,micro,0.12598425196850394,Q1,305.4642857142857,1079.7256703881956,2138.25,-189.0,2750.0,3.5347034690599175,384.4778571428571,1044.6193486269647,5382.69,-312.45,2750.0,2.716981821501425,349.71772727272725,1080.5906127842522,7693.79,-399.0,3275.0,3.0898937300411826,349.71772727272725,1080.5906127842522,22.0,-0.3688090158939752,0.3688090158939752,-384.70772727272725,384.70772727272725,7693.790000000002,12556.21,7693.790000000002,8,3,0,0,3,2.3622047244094486,88,69.29133858267717,99,77.95275590551181,100,78.74015748031496,0,1,0,0,0,0,0,0,0,0,0,0,0,1,0,0,0,0,-189.0,189.0,-156.78,156.78,2750.0,2750.0,-67.45,67.45,1.0,1.0,7.0,30.0,2138.25,7693.79,1,3,-1,1,4,-34.99,1,60.89499999999998,-2.4564285714285585,34.99,279.92,0.0,64,8
2024-08-28,Expense,Professional Training Course,-299.0,training,credit_card,paid,LinkedIn Learning,https://tmsappstorage.blob.core.windows.net/receipts/11009988-7766-5544-3322-110099887766.png,2024,8,3,28,2,241,35,0,0,0,0,0,19963,22,100,-0.8660254037844384,-0.5000000000000004,0.9749279121818236,-0.22252093395631434,-0.8437282590292712,-0.5367705514607103,1,20,Summer,0,1,0,0,299.0,-1.0,0,1,5.703782474656201,-5.703782474656201,17.291616465790582,-17.291616465790582,89401.0,-26730899.0,medium,0.6968503937007874,Q3,280.60714285714283,1093.2061080710305,1964.25,-299.0,2750.0,3.8958598734871908,220.26357142857142,947.29112291196,3083.69,-312.45,2750.0,4.300716259016776,321.51260869565215,1064.376365646772,7394.79,-399.0,3275.0,3.310527602524988,321.51260869565215,1064.376365646772,23.0,-0.6019531464396246,0.6019531464396246,-620.5126086956521,620.5126086956521,7394.790000000002,12855.21,7394.790000000002,19,3,0,0,5,3.937007874015748,88,69.29133858267717,99,77.95275590551181,100,78.74015748031496,0,1,0,0,0,0,0,0,0,0,0,0,1,1,0,0,0,0,-34.99,34.99,-189.0,189.0,-156.78,156.78,-125.0,125.0,1.0,1.0,7.0,30.0,1964.25,7394.79,1,4,-1,1,10,-299.0,1,-55.00000000000004,-128.71535714285713,598.0,2392.0,0.0,152,38
2024-08-29,Income,Security Audit Services,1950.0,Unknown,Unknown,received,FinTech Startup,Unknown,2024,8,3,29,3,242,35,0,0,0,0,0,19964,23,99,-0.8660254037844384,-0.5000000000000004,0.43388373911755823,-0.900968867902419,-0.8528367217694595,-0.522177676659508,1,21,Summer,0,1,0,0,1950.0,1.0,1,0,7.576097340623111,7.576097340623111,44.15880433163923,44.15880433163923,3802500.0,7414875000.0,xlarge,0.8543307086614174,Q4,572.0342857142857,1240.0013024436323,4004.2400000000002,-299.0,2750.0,2.167704512493114,381.8671428571428,1038.0555229364666,5346.139999999999,-299.0,2750.0,2.7183682659097093,389.36625000000004,1092.7668798446107,9344.79,-399.0,3275.0,2.806526964893877,389.36625000000004,1092.7668798446107,24.0,1.3841123419781076,1.3841123419781076,1560.63375,1560.63375,9344.79,14805.21,9344.79,0,0,1,1,27,21.25984251968504,27,21.25984251968504,27,21.25984251968504,27,21.25984251968504,0,0,1,1,0,0,0,0,0,0,0,0,0,0,1,0,0,0,-299.0,299.0,-34.99,34.99,-189.0,189.0,-89.99,89.99,1.0,1.0,7.0,30.0,4004.2400000000002,9344.79,1,1,5,5,5,12075.0,5,992.4950000000002,-2.7942857142856785,5850.0,15600.0,0.0,0,0
2024-08-30,Expense,Fuel for Month,-245.89,fuel,credit_card,paid,BP,https://tmsappstorage.blob.core.windows.net/receipts/44332211-0099-8877-6655-443322110099.png,2024,8,3,30,4,243,35,0,0,0,0,0,19965,24,98,-0.8660254037844384,-0.5000000000000004,-0.433883739117558,-0.9009688679024191,-0.8616928164028521,-0.5074302810827518,1,22,Summer,0,1,0,0,245.89,-1.0,0,1,5.508942893303274,-5.508942893303274,15.680880077342598,-15.680880077342598,60461.89209999999,-14866974.648468997,medium,0.6692913385826772,Q3,539.1914285714286,1261.0376933360421,3774.34,-299.0,2750.0,2.3387569358754896,378.23214285714283,1040.3175860445292,5295.25,-299.0,2750.0,2.7504737650957765,363.95599999999996,1077.2769668203562,9098.9,-399.0,3275.0,2.9599098979556766,363.95599999999996,1077.2769668203562,25.0,-0.5550523291475544,0.5550523291475544,-609.846,609.846,9098.900000000001,15051.099999999999,9098.900000000001,5,3,0,0,9,7.086614173228346,88,69.29133858267717,99,77.95275590551181,100,78.74015748031496,0,1,0,0,0,1,0,0,0,0,0,0,0,1,0,0,0,0,1950.0,1950.0,-299.0,299.0,-34.99,34.99,-15.99,15.99,1.0,1.0,7.0,30.0,3774.34,9098.9,1,1,10,2,2,-402.57,3,26.554999999999914,-174.4325,983.56,1967.12,0.0,40,20
2024-08-31,Expense,Month-end Office Supplies,-123.45,office_supplies,credit_card,paid,Walmart,https://tmsappstorage.blob.core.windows.net/receipts/77665544-3322-1100-9988-776655443322.png,2024,8,3,31,5,244,35,1,0,1,0,0,19966,25,97,-0.8660254037844384,-0.5000000000000004,-0.9749279121818236,-0.2225209339563146,-0.8702939222685674,-0.49253272872205434,0,23,Summer,0,1,0,0,123.45,-1.0,0,1,4.823904028813601,-4.823904028813601,11.110805551354051,-11.110805551354051,15239.9025,-1881365.963625,small,0.44881889763779526,Q2,128.69857142857143,807.5874366578637,900.89,-299.0,1950.0,6.2750303106983605,372.6764285714286,1042.9598657416316,5217.47,-299.0,2750.0,2.7985667613580607,345.2096153846154,1059.830994570288,8975.45,-399.0,3275.0,3.0701085582146286,345.2096153846154,1059.830994570288,26.0,-0.4469270030462351,0.4469270030462351,-468.6596153846154,468.6596153846154,8975.45,15174.55,8975.45,11,3,0,0,6,4.724409448818897,88,69.29133858267717,99,77.95275590551181,100,78.74015748031496,0,1,0,0,0,0,0,1,0,0,0,0,0,1,0,0,0,0,-245.89,245.89,1950.0,1950.0,-299.0,299.0,2750.0,2750.0,1.0,1.0,7.0,30.0,900.89,8975.45,1,2,21,1,5,-280.23,2,-1036.725,70.40000000000002,617.25,987.6,123.45,88,55
2024-09-01,Income,September Retainer,2000.0,Unknown,Unknown,received,MainClient,Unknown,2024,9,3,1,6,245,35,1,1,0,0,0,19967,26,96,-1.0,-1.8369701987210297e-16,-0.7818314824680299,0.6234898018587334,-0.8786374941610001,-0.4774894280028391,0,1,Fall,0,0,1,0,2000.0,1.0,1,0,7.601402334583733,7.601402334583733,44.721359549995796,44.721359549995796,4000000.0,8000000000.0,xlarge,0.8740157480314961,Q4,436.81,1054.27125399491,3057.67,-299.0,2000.0,2.4135694100293263,532.3185714285714,1111.5849247798399,7452.46,-299.0,2750.0,2.088194897646919,406.4981481481482,1086.9497718316613,10975.45,-399.0,3275.0,2.6739353593205615,406.4981481481482,1086.9497718316613,27.0,1.428266754793086,1.428266754793086,1593.5018518518518,1593.5018518518518,10975.45,17174.55,10975.45,0,0,1,1,27,21.25984251968504,27,21.25984251968504,27,21.25984251968504,27,21.25984251968504,0,0,1,1,0,0,0,0,0,0,0,0,0,0,1,0,0,0,-123.45,123.45,-245.89,245.89,1950.0,1950.0,-156.78,156.78,1.0,1.0,7.0,30.0,3057.67,10975.45,1,1,3,3,3,14075.0,6,1122.9450000000002,230.1139285714286,12000.0,18000.0,2000.0,0,0
2024-09-02,Expense,Business Networking Lunch,-75.5,entertainment,credit_card,paid,Capital Grille,https://tmsappstorage.blob.core.windows.net/receipts/00998877-6655-4433-2211-009988776655.png,2024,9,3,2,0,246,36,0,0,0,0,0,19968,27,95,-1.0,-1.8369701987210297e-16,0.0,1.0,-0.886721063082993,-0.46230483047981086,1,1,Fall,0,0,1,0,75.5,-1.0,0,1,4.33729074083249,-4.33729074083249,8.689073598491383,-8.689073598491383,5700.25,-430368.875,small,0.2992125984251969,Q2,453.0242857142857,1043.863841741459,3171.17,-299.0,2000.0,2.304211660740425,376.9257142857144,1024.200805827228,5276.960000000001,-299.0,2750.0,2.7172484312144087,389.2839285714286,1070.5135486448282,10899.95,-399.0,3275.0,2.7499556752145824,389.2839285714286,1070.5135486448282,28.0,-0.40458292115667077,0.40458292115667077,-464.7839285714286,464.7839285714286,10899.95,17250.05,10899.95,3,3,0,0,4,3.149606299212598,88,69.29133858267717,99,77.95275590551181,100,78.74015748031496,0,1,0,0,0,0,0,0,0,0,0,0,0,1,0,0,0,0,2000.0,2000.0,-123.45,123.45,-245.89,245.89,-189.0,189.0,1.0,1.0,7.0,30.0,3171.17,10899.95,1,1,8,2,2,-232.28,2,23.975000000000033,85.82214285714288,0.0,679.5,0.0,27,0
2024-09-03,Expense,Software Documentation Tool,-25.99,software,credit_card,paid,Notion,https://tmsappstorage.blob.core.windows.net/receipts/33221100-9988-7766-5544-332211009988.png,2024,9,3,3,1,247,36,0,0,0,0,0,19969,28,94,-1.0,-1.8369701987210297e-16,0.7818314824680298,0.6234898018587336,-0.8945422369764496,-0.4469834295196741,1,2,Fall,0,0,1,0,25.99,-1.0,0,1,3.295466427029913,-3.295466427029913,5.098038838612354,-5.098038838612354,675.4800999999999,-17555.727798999997,micro,0.10236220472440945,Q1,454.31,1043.1678909296752,3180.17,-299.0,2000.0,2.2961587702882946,379.8871428571429,1022.8761597004383,5318.420000000001,-299.0,2750.0,2.6925790433636556,374.96413793103454,1054.048076998921,10873.960000000001,-399.0,3275.0,2.811063700157873,374.96413793103454,1054.048076998921,29.0,-0.36086122158727907,0.36086122158727907,-400.95413793103455,400.95413793103455,10873.960000000001,17276.04,10873.960000000001,16,3,0,0,15,11.811023622047244,88,69.29133858267717,99,77.95275590551181,100,78.74015748031496,0,1,0,0,1,0,0,0,0,0,0,0,0,1,0,0,0,0,-75.5,75.5,2000.0,2000.0,-123.45,123.45,-34.99,34.99,1.0,1.0,7.0,30.0,3180.17,10873.960000000001,1,2,11,1,7,-470.97,4,-1012.9949999999999,-35.21714285714285,25.99,233.91,0.0,144,16
2024-09-04,Expense,Vehicle Maintenance Check,-195.0,vehicle_expenses,credit_card,paid,AutoCare Plus,https://tmsappstorage.blob.core.windows.net/receipts/66554433-2211-0099-8877-665544332211.png,2024,9,3,4,2,248,36,0,0,0,0,0,19970,29,93,-1.0,-1.8369701987210297e-16,0.9749279121818236,-0.22252093395631434,-0.9020987014301837,-0.43152975897147144,1,3,Fall,0,0,1,0,195.0,-1.0,0,1,5.278114659230518,-5.278114659230518,13.96424004376894,-13.96424004376894,38025.0,-7414875.0,small,0.6259842519685039,Q3,469.1671428571429,1031.3242190781436,3284.17,-245.89,2000.0,2.1982021434782624,374.88714285714286,1025.7011671229407,5248.42,-299.0,2750.0,2.736026526025198,355.9653333333333,1040.9298933421662,10678.96,-399.0,3275.0,2.9242451325096255,355.9653333333333,1040.9298933421662,30.0,-0.5101119677844693,0.5101119677844693,-550.9653333333333,550.9653333333333,10678.960000000001,17471.04,10678.960000000001,22,3,0,0,3,2.3622047244094486,88,69.29133858267717,99,77.95275590551181,100,78.74015748031496,0,1,0,0,0,0,0,0,0,0,0,0,0,1,0,0,0,0,-25.99,25.99,-75.5,75.5,2000.0,2000.0,-299.0,299.0,1.0,1.0,7.0,30.0,3284.17,10678.96,1,3,-1,1,2,-195.0,1,-59.75,-212.40178571428575,390.0,1755.0,0.0,198,44
2024-09-05,Expense,Printer Cartridges,-67.99,office_supplies,credit_card,paid,Best Buy,https://tmsappstorage.blob.core.windows.net/receipts/99887766-5544-3322-1100-998877665544.png,2024,9,3,5,3,249,36,0,0,0,0,0,19971,30,92,-1.0,-1.8369701987210297e-16,0.43388373911755823,-0.900968867902419,-0.9093882203647925,-0.4159483918249421,1,4,Fall,0,0,1,0,67.99,-1.0,0,1,4.233961566558017,-4.233961566558017,8.245604889879214,-8.245604889879214,4622.6401,-314293.30039899994,small,0.2755905511811024,Q2,180.88285714285712,805.7806679180608,1266.1799999999998,-245.89,2000.0,4.454709974432092,376.4585714285714,1024.950742882927,5270.42,-299.0,2750.0,2.7226123155955273,359.5323333333333,1039.2296297562602,10785.97,-399.0,3275.0,2.8905039502879952,342.28935483870964,1026.262740292613,31.0,-0.397950928351861,0.397950928351861,-410.27935483870965,410.27935483870965,10610.970000000001,17539.030000000002,10610.970000000001,11,3,0,0,6,4.724409448818897,88,69.29133858267717,99,77.95275590551181,100,78.74015748031496,0,1,0,0,0,0,0,1,0,0,0,0,0,1,0,0,0,0,-195.0,195.0,-25.99,25.99,-75.5,75.5,1950.0,1950.0,1.0,1.0,7.0,30.0,1266.1799999999998,10785.97,1,4,5,1,1,-348.22,3,-20.99999999999999,-58.40678571428571,203.96999999999997,611.91,0.0,99,33
2024-09-06,Income,Cloud Migration Project,3450.0,Unknown,Unknown,received,Legacy Corp,Unknown,2024,9,3,6,4,250,36,0,0,0,0,0,19972,31,91,-1.0,-1.8369701987210297e-16,-0.433883739117558,-0.9009688679024191,-0.9164086366943458,-0.4002439388573056,1,5,Fall,0,0,1,0,3450.0,1.0,1,0,8.146419323098003,8.146419323098003,58.73670062235365,58.73670062235365,11902500.0,41063625000.0,xlarge,0.9763779527559056,Q4,708.8671428571428,1440.44639430183,4962.07,-195.0,3450.0,2.032040007519606,624.0292857142857,1303.5860521975778,8736.41,-299.0,3450.0,2.0889821712541066,477.5066666666667,1178.134307440292,14325.2,-399.0,3450.0,2.4672625319862034,439.40531250000004,1149.3688804253497,32.0,2.708744726427462,2.708744726427462,3010.5946875,3010.5946875,14060.970000000001,20989.030000000002,14060.970000000001,0,0,1,1,27,21.25984251968504,27,21.25984251968504,27,21.25984251968504,27,21.25984251968504,0,0,1,1,0,0,0,0,0,0,0,0,0,0,1,0,0,0,-67.99,67.99,-195.0,195.0,-25.99,25.99,-245.89,245.89,1.0,1.0,7.0,30.0,4962.07,14325.2,1,1,5,5,5,17525.0,7,1822.5000000000005,230.8882142857143,13800.0,31050.0,0.0,0,0
2024-09-07,Expense,Lunch with Team,-89.45,meals_entertainment,credit_card,paid,TGI Fridays,https://tmsappstorage.blob.core.windows.net/receipts/22110099-8877-6655-4433-221100998877.png,2024,9,3,7,5,251,36,1,0,0,0,0,19973,32,90,-1.0,-1.8369701987210297e-16,-0.9749279121818236,-0.2225209339563146,-0.9231578729647039,-0.38442104726885545,0,6,Fall,0,0,1,0,89.45,-1.0,0,1,4.504797211841304,-4.504797211841304,9.457801012920498,-9.457801012920498,8001.302500000001,-715716.508625,small,0.3858267716535433,Q2,713.7242857142857,1437.2258104053233,4996.07,-195.0,3450.0,2.0136989019043496,421.2114285714286,1160.3973387783842,5896.96,-299.0,3450.0,2.7549046869738607,487.825,1171.53001683107,14634.75,-312.45,3450.0,2.4015374710830115,423.37939393939394,1135.007242149085,33.0,-0.41690200233204977,0.41690200233204977,-512.829393939394,512.829393939394,13971.52,21078.480000000003,13971.52,10,3,0,0,9,7.086614173228346,88,69.29133858267717,99,77.95275590551181,100,78.74015748031496,0,1,0,0,0,0,1,0,0,0,0,0,0,1,0,0,0,0,3450.0,3450.0,-67.99,67.99,-195.0,195.0,-123.45,123.45,1.0,1.0,7.0,30.0,4996.07,14634.75,1,1,26,2,2,-168.35000000000002,2,-10.730000000000066,26.451785714285705,447.25,805.0500000000001,89.45,90,50
2024-09-08,Expense,Parking for Client Meeting,-20.0,travel,credit_card,paid,ParkWhiz,https://tmsappstorage.blob.core.windows.net/receipts/55443322-1100-9988-7766-554433221100.png,2024,9,3,8,6,252,36,1,0,0,0,0,19974,33,89,-1.0,-1.8369701987210297e-16,-0.7818314824680299,0.6234898018587334,-0.9296339319682695,-0.3684843993077793,0,6,Fall,0,0,1,0,20.0,-1.0,0,1,3.044522437723423,-3.044522437723423,4.47213595499958,-4.47213595499958,400.0,-8000.0,micro,0.07874015748031496,Q1,425.1528571428571,1335.0805224868684,2976.0699999999997,-195.0,3450.0,3.140236505662864,430.9814285714286,1155.722979935784,6033.74,-299.0,3450.0,2.681607381010944,377.9916666666667,1049.2959174085402,11339.75,-312.45,3450.0,2.7759763241919977,410.3388235294118,1120.2614607983662,34.0,-0.35557152293204464,0.35557152293204464,-430.3388235294118,430.3388235294118,13951.52,21098.480000000003,13951.52,20,3,0,0,6,4.724409448818897,88,69.29133858267717,99,77.95275590551181,100,78.74015748031496,0,1,0,0,0,0,0,0,1,0,0,0,0,1,0,0,0,0,-89.45,89.45,3450.0,3450.0,-67.99,67.99,2000.0,2000.0,1.0,1.0,7.0,30.0,2976.0699999999997,11339.75,1,2,13,1,5,-244.0,3,-1735.0000000000002,131.59214285714282,120.0,180.0,20.0,180,120
2024-09-09,Expense,Office Utilities,-125.67,telephone,bank_transfer,paid,Electric Company,Unknown,2024,9,3,9,0,253,37,0,0,0,0,0,19975,34,88,-1.0,-1.8369701987210297e-16,0.0,1.0,-0.9358348973349941,-0.35243871088460327,1,6,Fall,0,0,1,0,125.67,-1.0,0,1,4.841585279495541,-4.841585279495541,11.210263154805956,-11.210263154805956,15792.948900000001,-1984699.8882630002,small,0.48031496062992124,Q2,417.9857142857142,1338.3468017278774,2925.8999999999996,-195.0,3450.0,3.2018960361239768,435.505,1153.230921099833,6097.07,-299.0,3450.0,2.648031414334699,379.0286666666667,1048.764426136392,11370.86,-312.45,3450.0,2.7669791716802212,395.0242857142857,1107.3766850701595,35.0,-0.4488874589752202,0.4488874589752202,-520.6942857142857,520.6942857142857,13825.85,21224.15,13825.85,18,1,0,0,6,4.724409448818897,10,7.874015748031496,99,77.95275590551181,100,78.74015748031496,0,1,0,0,0,0,0,0,0,1,0,0,0,0,0,1,0,0,-20.0,20.0,-89.45,89.45,3450.0,3450.0,-75.5,75.5,1.0,1.0,7.0,30.0,2925.8999999999996,11370.86,1,1,18,25,2,-215.66,2,-18.11000000000002,1.0535714285714386,0.0,1131.03,0.0,162,0
2024-09-10,Expense,Wireless Mouse,-35.99,computer_equipment,credit_card,paid,Amazon,https://tmsappstorage.blob.core.windows.net/receipts/88776655-4433-2211-0099-887766554433.png,2024,9,3,10,1,254,37,0,0,0,0,0,19976,35,87,-1.0,-1.8369701987210297e-16,0.7818314824680298,0.6234898018587336,-0.9417589340994617,-0.33628873017668287,1,7,Fall,0,0,1,0,35.99,-1.0,0,1,3.610647605844363,-3.610647605844363,5.999166608788258,-5.999166608788258,1295.2801000000002,-46617.130799000006,micro,0.14173228346456693,Q1,416.5571428571428,1338.9049131499753,2915.8999999999996,-195.0,3450.0,3.214216671370701,435.4335714285715,1153.262334707717,6096.070000000001,-299.0,3450.0,2.6485379409862477,378.9956666666667,1048.7779185143695,11369.87,-312.45,3450.0,2.7672556990916415,383.0516666666667,1093.8038360863172,36.0,-0.36969210415027476,0.36969210415027476,-419.0416666666667,419.0416666666667,13789.86,21260.140000000003,13789.86,2,3,0,0,5,3.937007874015748,88,69.29133858267717,99,77.95275590551181,100,78.74015748031496,0,1,0,0,0,0,0,0,0,0,1,0,0,1,0,0,0,0,-125.67,125.67,-20.0,20.0,-89.45,89.45,-25.99,25.99,1.0,1.0,7.0,30.0,2915.8999999999996,11369.87,1,1,-1,2,2,-35.99,1,-7.9950000000000045,-111.0117857142857,35.99,323.91,0.0,18,2
2024-09-11,Income,API Integration Services,2650.0,Unknown,Unknown,received,SaaS Company,Unknown,2024,9,3,11,2,255,37,0,0,0,0,0,19977,36,86,-1.0,-1.8369701987210297e-16,0.9749279121818236,-0.22252093395631434,-0.9474042892438845,-0.32003923622313857,1,8,Fall,0,0,1,0,2650.0,1.0,1,0,7.8826922062890254,7.8826922062890254,51.478150704935004,51.478150704935004,7022500.0,18609625000.0,xlarge,0.9212598425196851,Q4,822.9857142857143,1539.1541925232523,5760.9,-125.67,3450.0,1.8702076667990706,646.0764285714286,1272.0035127709546,9045.07,-245.89,3450.0,1.9688127542178628,469.959,1123.3828368948853,14098.77,-312.45,3450.0,2.3903847716394093,444.32054054054055,1141.0813644276836,37.0,2.0022741213878064,2.0022741213878064,2205.6794594594594,2205.6794594594594,16439.86,23910.140000000003,16439.86,0,0,1,1,27,21.25984251968504,27,21.25984251968504,27,21.25984251968504,27,21.25984251968504,0,0,1,1,0,0,0,0,0,0,0,0,0,0,1,0,0,0,-35.99,35.99,-125.67,125.67,-20.0,20.0,-195.0,195.0,1.0,1.0,7.0,30.0,5760.9,14098.77,1,1,5,5,5,20175.0,8,1387.8350000000003,40.92035714285702,5300.0,23850.0,0.0,0,0
2024-09-12,Expense,Equipment Insurance,-145.0,other,bank_transfer,paid,Farmers Insurance,Unknown,2024,9,3,12,3,256,37,0,0,0,0,0,19978,37,85,-1.0,-1.8369701987210297e-16,0.43388373911755823,-0.900968867902419,-0.9527692922168511,-0.30369503751065885,1,9,Fall,0,0,1,0,145.0,-1.0,0,1,4.983606621708336,-4.983606621708336,12.041594578792296,-12.041594578792296,21025.0,-3048625.0,small,0.5039370078740157,Q2,811.9842857142856,1546.8400676740646,5683.889999999999,-145.0,3450.0,1.9050123196821989,496.4335714285714,1229.3210015952654,6950.07,-245.89,3450.0,2.476305133953143,466.12533333333334,1125.3423327078601,13983.76,-312.45,3450.0,2.4142483839279136,428.8121052631579,1129.608396014654,38.0,-0.4659575549694909,0.4659575549694909,-573.812105263158,573.812105263158,16294.86,24055.140000000003,16294.86,12,1,0,0,4,3.149606299212598,10,7.874015748031496,99,77.95275590551181,100,78.74015748031496,0,1,0,0,0,0,0,0,0,0,0,0,0,0,0,1,0,0,2650.0,2650.0,-35.99,35.99,-125.67,125.67,-67.99,67.99,1.0,1.0,7.0,30.0,5683.889999999999,13983.76,1,1,-1,3,3,-145.0,1,-54.504999999999924,-190.07464285714283,435.0,1305.0,0.0,108,36
2024-09-13,Expense,Client Meeting Coffee,-12.75,meals_entertainment,credit_card,paid,Coffee Bean,https://tmsappstorage.blob.core.windows.net/receipts/11009988-7766-5544-3322-110099887766.png,2024,9,3,13,4,257,37,0,0,0,0,0,19979,38,84,-1.0,-1.8369701987210297e-16,-0.433883739117558,-0.9009688679024191,-0.9578523554276669,-0.28726097055059635,1,10,Fall,0,0,1,0,12.75,-1.0,0,1,2.6210388241125804,-2.6210388241125804,3.570714214271425,-3.570714214271425,162.5625,-2072.671875,micro,0.015748031496062992,Q1,317.3057142857142,1029.918822025263,2221.1399999999994,-145.0,2650.0,3.2458250061575775,513.0864285714285,1220.035712028433,7183.21,-195.0,3450.0,2.377836645232154,399.03366666666665,1090.1910137519035,11971.01,-312.45,3450.0,2.7320777789473993,417.49,1116.8863843292208,39.0,-0.34916913307387276,0.34916913307387276,-430.24,430.24,16282.11,24067.890000000003,16282.11,10,3,0,0,9,7.086614173228346,88,69.29133858267717,99,77.95275590551181,100,78.74015748031496,0,1,0,0,0,0,1,0,0,0,0,0,0,1,0,0,0,0,-145.0,145.0,2650.0,2650.0,-35.99,35.99,3450.0,3450.0,1.0,1.0,7.0,30.0,2221.1399999999994,11971.01,1,1,6,3,3,-181.10000000000002,3,-1331.3749999999998,98.42035714285714,51.0,114.75,0.0,90,40
2024-09-14,Expense,Professional Development Book,-39.99,training,credit_card,paid,Amazon,https://tmsappstorage.blob.core.windows.net/receipts/44332211-0099-8877-6655-443322110099.png,2024,9,3,14,5,258,37,1,0,0,0,0,19980,39,83,-1.0,-1.8369701987210297e-16,-0.9749279121818236,-0.2225209339563146,-0.9626519747161487,-0.2707418984477642,0,11,Fall,0,0,1,0,39.99,-1.0,0,1,3.7133281345162463,-3.7133281345162463,6.323764701504951,-6.323764701504951,1599.2001000000002,-63952.01199900001,micro,0.14960629921259844,Q1,324.3714285714285,1026.8282253202267,2270.5999999999995,-145.0,2650.0,3.1655939299046896,519.0478571428572,1216.88600604594,7266.67,-195.0,3450.0,2.3444582022636444,408.1156666666667,1085.1828900003634,12243.470000000001,-299.0,3450.0,2.6590081651697517,406.053,1104.8447295555457,40.0,-0.37322445717547303,0.37322445717547303,-446.043,446.043,16242.12,24107.880000000005,16242.12,19,3,0,0,5,3.937007874015748,88,69.29133858267717,99,77.95275590551181,100,78.74015748031496,0,1,0,0,0,0,0,0,0,0,0,0,1,1,0,0,0,0,-12.75,12.75,-145.0,145.0,2650.0,2650.0,-89.45,89.45,1.0,1.0,7.0,30.0,2270.5999999999995,12243.470000000001,1,2,17,1,1,-338.99,2,52.50499999999998,2.030714285714298,199.95000000000002,359.91,39.99,171,95
2024-09-15,Expense,Antivirus Software,-79.99,software,credit_card,paid,Norton,https://tmsappstorage.blob.core.windows.net/receipts/77665544-3322-1100-9988-776655443322.png,2024,9,3,15,6,259,37,1,0,0,0,0,19981,40,82,-1.0,-1.8369701987210297e-16,-0.7818314824680299,0.6234898018587334,-0.9671667297977312,-0.2541427094613622,0,11,Fall,0,0,1,0,79.99,-1.0,0,1,4.3943256902608985,-4.3943256902608985,8.94371287553441,-8.94371287553441,6398.400099999999,-511808.0239989999,small,0.3425196850393701,Q2,315.80142857142846,1030.4254457654629,2210.609999999999,-145.0,2650.0,3.2628903878830924,370.4771428571429,1147.1419896382527,5186.68,-195.0,3450.0,3.0963907268108954,411.94933333333336,1083.1800716693463,12358.480000000001,-299.0,3450.0,2.629401200639592,394.1982926829269,1093.5843483812816,41.0,-0.40854798742745585,0.40854798742745585,-474.1882926829269,474.1882926829269,16162.130000000001,24187.870000000006,16162.130000000001,16,3,0,0,15,11.811023622047244,88,69.29133858267717,99,77.95275590551181,100,78.74015748031496,0,1,0,0,1,0,0,0,0,0,0,0,0,1,0,0,0,0,-39.99,39.99,-12.75,12.75,-145.0,145.0,-20.0,20.0,1.0,1.0,7.0,30.0,2210.609999999999,12358.480000000001,1,3,12,1,3,-550.96,5,-33.620000000000005,-90.48964285714285,479.93999999999994,719.91,79.99,144,96
2024-09-16,Income,Website Redesign,1875.0,Unknown,Unknown,received,RetailStore,Unknown,2024,9,3,16,0,260,38,0,0,0,0,0,19982,41,81,-1.0,-1.8369701987210297e-16,0.0,1.0,-0.97139528468375,-0.23746831555846842,1,11,Fall,0,0,1,0,1875.0,1.0,1,0,7.53689712956617,7.53689712956617,43.30127018922193,43.30127018922193,3515625.0,6591796875.0,xlarge,0.84251968503937,Q4,601.6114285714284,1157.2273808465443,4211.279999999999,-145.0,2650.0,1.9235462058865267,509.79857142857145,1205.758575349382,7137.18,-195.0,3450.0,2.365166642131955,475.9716666666667,1111.5883166584695,14279.150000000001,-299.0,3450.0,2.335408585227698,429.4554761904762,1104.0682406428098,42.0,1.3178807227556397,1.3178807227556397,1445.5445238095238,1445.5445238095238,18037.13,26062.870000000006,18037.13,0,0,1,1,27,21.25984251968504,27,21.25984251968504,27,21.25984251968504,27,21.25984251968504,0,0,1,1,0,0,0,0,0,0,0,0,0,0,1,0,0,0,-79.99,79.99,-39.99,39.99,-12.75,12.75,-125.67,125.67,1.0,1.0,7.0,30.0,4211.279999999999,14279.150000000001,1,1,5,5,5,22050.0,9,957.4950000000002,13.499999999999883,0.0,16875.0,0.0,0,0
2024-09-17,Expense,Fuel for Business Travel,-92.45,fuel,credit_card,paid,Shell,https://tmsappstorage.blob.core.windows.net/receipts/00998877-6655-4433-2211-009988776655.png,2024,9,3,17,1,261,38,0,0,0,0,0,19983,42,80,-1.0,-1.8369701987210297e-16,0.7818314824680298,0.6234898018587336,-0.9753363880767837,-0.2207236509605022,1,12,Fall,0,0,1,0,92.45,-1.0,0,1,4.537426533901572,-4.537426533901572,9.615092303249096,-9.615092303249096,8547.0025,-790170.3811250001,small,0.41732283464566927,Q2,593.5457142857141,1162.596344435694,4154.819999999999,-145.0,2650.0,1.9587309224105642,505.0514285714285,1208.1587102749318,7070.719999999999,-195.0,3450.0,2.3921498721274563,480.723,1108.7456166508232,14421.69,-299.0,3450.0,2.3064126672757976,417.31813953488376,1093.7450371419507,43.0,-0.4195512671009485,0.4195512671009485,-509.76813953488374,509.76813953488374,17944.68,26155.320000000007,17944.68,5,3,0,0,9,7.086614173228346,88,69.29133858267717,99,77.95275590551181,100,78.74015748031496,0,1,0,0,0,1,0,0,0,0,0,0,0,1,0,0,0,0,1875.0,1875.0,-79.99,79.99,-39.99,39.99,-35.99,35.99,1.0,1.0,7.0,30.0,4154.819999999999,14421.69,1,1,18,2,2,-495.02,4,-6.230000000000097,-151.9496428571428,92.45,832.0500000000001,0.0,45,5
2024-09-18,Expense,Business Cards Printing,-45.0,supplies,credit_card,paid,FedEx Office,https://tmsappstorage.blob.core.windows.net/receipts/33221100-9988-7766-5544-332211009988.png,2024,9,3,18,2,262,38,0,0,0,0,0,19984,43,79,-1.0,-1.8369701987210297e-16,0.9749279121818236,-0.22252093395631434,-0.9789888737409319,-0.20391367068311472,1,13,Fall,0,0,1,0,45.0,-1.0,0,1,3.828641396489095,-3.828641396489095,6.708203932499369,-6.708203932499369,2025.0,-91125.0,micro,0.16929133858267717,Q1,208.5457142857142,736.0868337104703,1459.8199999999995,-145.0,1875.0,3.5296186077552667,515.7657142857142,1202.1229467501637,7220.719999999999,-145.0,3450.0,2.3307538935871066,409.223,1069.1786664156166,12276.69,-299.0,3450.0,2.6127042380697483,406.8109090909091,1083.1968731959487,44.0,-0.37764872933953386,0.37764872933953386,-451.8109090909091,451.8109090909091,17899.68,26200.320000000007,17899.68,17,3,0,0,5,3.937007874015748,88,69.29133858267717,99,77.95275590551181,100,78.74015748031496,0,1,0,0,0,0,0,0,0,0,0,1,0,1,0,0,0,0,-92.45,92.45,1875.0,1875.0,-79.99,79.99,2650.0,2650.0,1.0,1.0,7.0,30.0,1459.8199999999995,12276.69,1,2,32,1,4,-90.67,2,-960.0000000000001,73.41392857142856,90.0,405.0,0.0,153,34
2024-09-19,Expense,Office Rent September,-1200.0,rent,bank_transfer,paid,Property Management,Unknown,2024,9,3,19,3,263,38,0,0,0,0,0,19985,44,78,-1.0,-1.8369701987210297e-16,0.43388373911755823,-0.900968867902419,-0.9823516608469237,-0.18704334906991657,1,14,Fall,0,0,1,0,1200.0,-1.0,0,1,7.0909098220799835,-7.0909098220799835,34.64101615137755,-34.64101615137755,1440000.0,-1728000000.0,xlarge,0.7834645669291339,Q4,57.831428571428496,908.3818806248944,404.8199999999995,-1200.0,1875.0,15.70740863686149,434.90785714285715,1279.959250488249,6088.71,-1200.0,3450.0,2.9430584650665716,371.47133333333335,1105.952132554393,11144.140000000001,-1200.0,3450.0,2.9772206717280825,371.104,1097.2800265043809,45.0,-1.3976156653655367,1.3976156653655367,-1571.104,1571.104,16699.68,27400.320000000007,16699.68,14,1,0,0,2,1.574803149606299,10,7.874015748031496,99,77.95275590551181,100,78.74015748031496,0,1,0,0,0,0,0,0,0,0,0,0,0,0,0,1,0,0,-45.0,45.0,-92.45,92.45,1875.0,1875.0,-145.0,145.0,1.0,1.0,7.0,30.0,404.8199999999995,11144.140000000001,1,1,-1,7,3,-1200.0,1,-553.7750000000001,-128.00821428571427,3600.0,10800.0,0.0,126,42
2024-09-20,Expense,Backup Drive,-189.99,computer_equipment,credit_card,paid,Seagate,https://tmsappstorage.blob.core.windows.net/receipts/66554433-2211-0099-8877-665544332211.png,2024,9,3,20,4,264,38,0,0,0,0,0,19986,45,77,-1.0,-1.8369701987210297e-16,-0.433883739117558,-0.9009688679024191,-0.9854237542919524,-0.17011767832049052,1,15,Fall,0,0,1,0,189.99,-1.0,0,1,5.252221070655064,-5.252221070655064,13.783686009192172,-13.783686009192172,36096.2001,-6857917.056999001,small,0.6141732283464567,Q3,32.511428571428496,913.1348797672882,227.57999999999947,-1200.0,1875.0,28.086581238997418,174.9085714285714,946.7013898378302,2448.72,-1200.0,2650.0,5.412550008873871,369.30500000000006,1107.0212862724663,11079.150000000001,-1200.0,3450.0,2.9975800118397156,358.90630434782605,1088.1688442503535,46.0,-0.5056876956204085,0.5056876956204085,-548.8963043478261,548.8963043478261,16509.69,27590.31000000001,16509.69,2,3,0,0,5,3.937007874015748,88,69.29133858267717,99,77.95275590551181,100,78.74015748031496,0,1,0,0,0,0,0,0,0,0,1,0,0,1,0,0,0,0,-1200.0,1200.0,-45.0,45.0,-92.45,92.45,-12.75,12.75,1.0,1.0,7.0,30.0,227.57999999999947,11079.150000000001,1,1,10,2,3,-225.98000000000002,2,-72.49500000000003,-164.6435714285714,759.96,1709.91,0.0,18,8
2024-09-21,Income,Custom Software Development,4200.0,Unknown,Unknown,received,Manufacturing Co,Unknown,2024,9,3,21,5,265,38,1,0,0,0,0,19987,46,76,-1.0,-1.8369701987210297e-16,-0.9749279121818236,-0.2225209339563146,-0.9882042449941422,-0.15314166701312007,0,16,Fall,0,0,1,0,4200.0,1.0,1,0,8.343077871169383,8.343077871169383,64.8074069840786,64.8074069840786,17640000.0,74088000000.0,xlarge,1.0,Q4,638.2242857142857,1816.4700167527967,4467.57,-1200.0,4200.0,2.8461311445079938,481.29785714285714,1426.8954953980906,6738.17,-1200.0,4200.0,2.964682834593557,512.3046666666667,1305.0193929797879,15369.140000000001,-1200.0,4200.0,2.547350195872615,440.63170212765965,1213.3774313376891,47.0,3.3710609186521396,3.3710609186521396,3759.3682978723405,3759.3682978723405,20709.69,31790.31000000001,20709.69,0,0,1,1,27,21.25984251968504,27,21.25984251968504,27,21.25984251968504,27,21.25984251968504,0,0,1,1,0,0,0,0,0,0,0,0,0,0,1,0,0,0,-189.99,189.99,-1200.0,1200.0,-45.0,45.0,-39.99,39.99,1.0,1.0,7.0,30.0,4467.57,15369.140000000001,1,1,5,5,2,26250.0,10,2700.0000000000005,271.5157142857143,21000.0,37800.0,4200.0,0,0
2024-09-22,Expense,Internet Upgrade,-99.99,telephone,credit_card,paid,Spectrum,https://tmsappstorage.blob.core.windows.net/receipts/99887766-5544-3322-1100-998877665544.png,2024,9,3,22,6,266,38,1,0,0,0,0,19988,47,75,-1.0,-1.8369701987210297e-16,-0.7818314824680299,0.6234898018587334,-0.9906923101615609,-0.13612033862266704,0,16,Fall,0,0,1,0,99.99,-1.0,0,1,4.6150215020384655,-4.6150215020384655,9.999499987499375,-9.999499987499375,9998.0001,-999700.0299989999,small,0.4409448818897638,Q2,635.3671428571428,1817.80322363482,4447.57,-1200.0,4200.0,2.8610280592421797,475.5842857142857,1429.2154602853557,6658.18,-1200.0,4200.0,3.0051780582674215,509.5046666666667,1306.2814710882592,15285.140000000001,-1200.0,4200.0,2.563826313180499,429.36875000000003,1202.9333227212962,48.0,-0.42620975255344723,0.42620975255344723,-529.35875,529.35875,20609.699999999997,31890.30000000001,20609.699999999997,18,3,0,0,6,4.724409448818897,88,69.29133858267717,99,77.95275590551181,100,78.74015748031496,0,1,0,0,0,0,0,0,0,1,0,0,0,1,0,0,0,0,4200.0,4200.0,-189.99,189.99,-1200.0,1200.0,-79.99,79.99,1.0,1.0,7.0,30.0,4447.57,15285.140000000001,1,1,13,2,2,-315.65,3,44.99999999999984,89.81928571428573,599.9399999999999,899.91,99.99,162,108
2024-09-23,Expense,Conference Registration,-395.0,training,credit_card,paid,TechConf 2024,https://tmsappstorage.blob.core.windows.net/receipts/22110099-8877-6655-4433-221100998877.png,2024,9,3,23,0,267,39,0,0,0,0,0,19989,48,74,-1.0,-1.8369701987210297e-16,0.0,1.0,-0.9928872135356962,-0.11905873003404988,1,16,Fall,0,0,1,0,395.0,-1.0,0,1,5.981414211254481,-5.981414211254481,19.87460691435179,-19.87460691435179,156025.0,-61629875.0,medium,0.7322834645669292,Q3,311.08142857142855,1761.4051973867208,2177.5699999999997,-1200.0,4200.0,5.662199783110093,456.3464285714286,1439.7053054577477,6388.85,-1200.0,4200.0,3.154851698882971,404.6713333333334,1245.0367075262548,12140.140000000001,-1200.0,4200.0,3.0766614903771816,412.5448979591837,1196.1483149661433,49.0,-0.6867296190443832,0.6867296190443832,-807.5448979591837,807.5448979591837,20214.699999999997,32285.30000000001,20214.699999999997,19,3,0,0,5,3.937007874015748,88,69.29133858267717,99,77.95275590551181,100,78.74015748031496,0,1,0,0,0,0,0,0,0,0,0,0,1,1,0,0,0,0,-99.99,99.99,4200.0,4200.0,-189.99,189.99,1875.0,1875.0,1.0,1.0,7.0,30.0,2177.5699999999997,12140.140000000001,1,2,9,1,24,-733.99,3,-2297.5000000000005,156.5132142857143,0.0,3555.0,0.0,171,0
2024-09-24,Expense,Home Office Lighting,-78.99,home_office,credit_card,paid,Home Depot,https://tmsappstorage.blob.core.windows.net/receipts/55443322-1100-9988-7766-554433221100.png,2024,9,3,24,1,268,39,0,0,0,0,0,19990,49,73,-1.0,-1.8369701987210297e-16,0.7818314824680298,0.6234898018587336,-0.994788305609327,-0.10196189005174576,1,17,Fall,0,0,1,0,78.99,-1.0,0,1,4.3819016268607305,-4.3819016268607305,8.887631855561976,-8.887631855561976,6239.420099999999,-492851.7936989999,small,0.33070866141732286,Q2,313.0042857142857,1760.8985320081824,2191.0299999999997,-1200.0,4200.0,5.625796873642661,453.27500000000003,1440.8818247264148,6345.85,-1200.0,4200.0,3.1788248297973962,407.26433333333335,1243.9075620625665,12217.93,-1200.0,4200.0,3.0543002670564485,402.7142,1185.9188499254622,50.0,-0.4076648991711563,0.4076648991711563,-481.7042,481.7042,20135.709999999995,32364.29000000001,20135.709999999995,8,3,0,0,3,2.3622047244094486,88,69.29133858267717,99,77.95275590551181,100,78.74015748031496,0,1,0,0,0,0,0,0,0,0,0,0,0,1,0,0,0,0,-395.0,395.0,-99.99,99.99,4200.0,4200.0,-92.45,92.45,1.0,1.0,7.0,30.0,2191.0299999999997,12217.93,1,3,28,1,2,-113.97999999999999,2,10.500000000000005,57.072500000000055,78.99,710.91,0.0,72,8
2024-09-25,Expense,Vehicle Oil Change,-45.99,vehicle_expenses,credit_card,paid,Jiffy Lube,https://tmsappstorage.blob.core.windows.net/receipts/88776655-4433-2211-0099-887766554433.png,2024,9,3,25,2,269,39,0,0,0,0,0,19991,50,72,-1.0,-1.8369701987210297e-16,0.9749279121818236,-0.22252093395631434,-0.9963950238187231,-0.08483487790576538,1,18,Fall,0,0,1,0,45.99,-1.0,0,1,3.849934813114724,-3.849934813114724,6.7815927332743895,-6.7815927332743895,2115.0801,-97272.53379900001,micro,0.20078740157480315,Q1,312.86285714285714,1760.932117220066,2190.04,-1200.0,4200.0,5.628447343674299,260.70428571428573,1297.759066217397,3649.8600000000006,-1200.0,4200.0,4.977896940442526,412.03133333333335,1241.8159849320045,12360.94,-1200.0,4200.0,3.013887256791161,393.91607843137257,1175.6798893986042,51.0,-0.37852298671327045,0.37852298671327045,-439.9060784313726,439.9060784313726,20089.719999999994,32410.280000000013,20089.719999999994,22,3,0,0,3,2.3622047244094486,88,69.29133858267717,99,77.95275590551181,100,78.74015748031496,0,1,0,0,0,0,0,0,0,0,0,0,0,1,0,0,0,0,-78.99,78.99,-395.0,395.0,-99.99,99.99,-45.0,45.0,1.0,1.0,7.0,30.0,2190.04,12360.94,1,4,21,1,7,-240.99,2,174.505,-32.53464285714283,91.98,413.91,0.0,198,44
2024-09-26,Income,System Integration Project,2950.0,Unknown,Unknown,received,Enterprise Ltd,Unknown,2024,9,3,26,3,270,39,0,0,0,0,0,19992,51,71,-1.0,-1.8369701987210297e-16,0.43388373911755823,-0.900968867902419,-0.9977068927101168,-0.06768276175455162,1,19,Fall,0,0,1,0,2950.0,1.0,1,0,7.989899374942939,7.989899374942939,54.31390245600108,54.31390245600108,8702500.0,25672375000.0,xlarge,0.952755905511811,Q4,905.72,1862.3762899228147,6340.04,-395.0,4200.0,2.0562384510917444,481.77571428571434,1474.8616915948646,6744.860000000001,-1200.0,4200.0,3.0613035233241463,511.53100000000006,1321.7745731306939,15345.930000000002,-1200.0,4200.0,2.58395790896484,443.07153846153847,1216.8673993680027,52.0,2.2672005982776775,2.2672005982776775,2506.9284615384613,2506.9284615384613,23039.719999999994,35360.28000000001,23039.719999999994,0,0,1,1,27,21.25984251968504,27,21.25984251968504,27,21.25984251968504,27,21.25984251968504,0,0,1,1,0,0,0,0,0,0,0,0,0,0,1,0,0,0,-45.99,45.99,-78.99,78.99,-395.0,395.0,-1200.0,1200.0,1.0,1.0,7.0,30.0,6340.04,15345.930000000002,1,1,5,5,5,29200.0,11,1514.495,33.89249999999994,8850.0,26550.0,0.0,0,0
2024-09-27,Expense,Client Dinner,-134.67,meals_entertainment,credit_card,paid,Ruth's Chris,https://tmsappstorage.blob.core.windows.net/receipts/11009988-7766-5544-3322-110099887766.png,2024,9,3,27,4,271,39,0,0,0,0,0,19993,52,70,-1.0,-1.8369701987210297e-16,-0.433883739117558,-0.9009688679024191,-0.9987235240803972,-0.050510617185222886,1,20,Fall,0,0,1,0,134.67,-1.0,0,1,4.910225466497217,-4.910225466497217,11.604740410711477,-11.604740410711477,18136.008899999997,-2442376.3185629994,small,0.49606299212598426,Q2,913.6228571428571,1857.061587272703,6395.36,-395.0,4200.0,2.0326347712887034,473.06714285714287,1478.3621136734582,6622.9400000000005,-1200.0,4200.0,3.1250576921168567,517.0086666666667,1318.6365441118062,15510.26,-1200.0,4200.0,2.550511488740626,432.1707547169811,1207.720095402027,53.0,-0.45683525328191626,0.45683525328191626,-566.8407547169811,566.8407547169811,22905.049999999996,35494.95000000001,22905.049999999996,10,3,0,0,9,7.086614173228346,88,69.29133858267717,99,77.95275590551181,100,78.74015748031496,0,1,0,0,0,0,1,0,0,0,0,0,0,1,0,0,0,0,2950.0,2950.0,-45.99,45.99,-78.99,78.99,-189.99,189.99,1.0,1.0,7.0,30.0,6395.36,15510.26,1,1,14,2,3,-315.77,4,-44.34000000000002,-234.1078571428572,538.68,1212.03,0.0,90,40
2024-09-28,Expense,Software Update License,-149.99,software,credit_card,paid,Microsoft,https://tmsappstorage.blob.core.windows.net/receipts/44332211-0099-8877-6655-443322110099.png,2024,9,3,28,5,272,39,1,0,0,0,0,19994,53,69,-1.0,-1.8369701987210297e-16,-0.9749279121818236,-0.2225209339563146,-0.9994446170919858,-0.033323525711631344,0,21,Fall,0,0,1,0,149.99,-1.0,0,1,5.017213609456379,-5.017213609456379,12.247040458821061,-12.247040458821061,22497.0001,-3374325.0449990006,small,0.5118110236220472,Q3,292.19571428571425,1177.5583609862288,2045.3699999999997,-395.0,2950.0,4.030032965626563,465.21000000000004,1481.587435946271,6512.9400000000005,-1200.0,4200.0,3.184771255876423,447.00900000000007,1295.4787716818353,13410.270000000002,-1200.0,4200.0,2.898104449086786,421.39000000000004,1198.8925873771698,54.0,-0.47036416536842574,0.47036416536842574,-571.3800000000001,571.3800000000001,22755.059999999994,35644.94000000001,22755.059999999994,16,3,0,0,15,11.811023622047244,88,69.29133858267717,99,77.95275590551181,100,78.74015748031496,0,1,0,0,1,0,0,0,0,0,0,0,0,1,0,0,0,0,-134.67,134.67,2950.0,2950.0,-45.99,45.99,4200.0,4200.0,1.0,1.0,7.0,30.0,2045.3699999999997,13410.270000000002,1,2,13,1,1,-700.95,6,-1549.9949999999997,121.41607142857141,749.95,1349.91,149.99,144,80
2024-09-29,Expense,Office Supplies Restock,-89.45,office_supplies,credit_card,paid,Costco,https://tmsappstorage.blob.core.windows.net/receipts/77665544-3322-1100-9988-776655443322.png,2024,9,3,29,6,273,39,1,0,0,0,0,19995,54,68,-1.0,-1.8369701987210297e-16,-0.7818314824680299,0.6234898018587334,-0.9998699583618592,-0.016126573270657762,0,21,Fall,0,0,1,0,89.45,-1.0,0,1,4.504797211841304,-4.504797211841304,9.457801012920498,-9.457801012920498,8001.302500000001,-715716.508625,small,0.3858267716535433,Q2,293.70142857142855,1176.9798998344395,2055.91,-395.0,2950.0,4.007402706753251,464.5342857142858,1481.8573474877048,6503.4800000000005,-1200.0,4200.0,3.189984879607205,452.2236666666667,1292.9057842370723,13566.710000000001,-1200.0,4200.0,2.858996287759683,412.10200000000003,1189.7355365582848,55.0,-0.41690200233204977,0.41690200233204977,-501.552,501.552,22665.609999999993,35734.39000000001,22665.609999999993,11,3,0,0,6,4.724409448818897,88,69.29133858267717,99,77.95275590551181,100,78.74015748031496,0,1,0,0,0,0,0,1,0,0,0,0,0,1,0,0,0,0,-149.99,149.99,-134.67,134.67,2950.0,2950.0,-99.99,99.99,1.0,1.0,7.0,30.0,2055.91,13566.710000000001,1,3,24,1,1,-437.67,4,22.609999999999985,24.498928571428593,536.7,805.0500000000001,89.45,99,66
2024-09-30,Income,Quarter-end Bonus,2500.0,Unknown,Unknown,received,MainClient,Unknown,2024,9,3,30,0,274,40,0,0,1,0,1,19996,55,67,-1.0,-1.8369701987210297e-16,0.0,1.0,-0.9999994220246925,0.001075151282798226,1,21,Fall,0,0,1,0,2500.0,1.0,1,0,7.824445930877619,7.824445930877619,50.0,50.0,6250000.0,15625000000.0,xlarge,0.9133858267716536,Q4,707.2728571428571,1384.9094164446803,4950.91,-149.99,2950.0,1.9580977870962637,509.17714285714294,1536.0418898305754,7128.480000000001,-1200.0,4200.0,3.016714146301603,539.672,1340.472472691677,16190.16,-1200.0,4200.0,2.483865149001017,449.3858928571429,1211.4370732042726,56.0,1.869810882942871,1.869810882942871,2050.614107142857,2050.614107142857,25165.609999999993,38234.39000000001,25165.609999999993,0,0,1,1,27,21.25984251968504,27,21.25984251968504,27,21.25984251968504,27,21.25984251968504,0,0,1,1,0,0,0,0,0,0,0,0,0,0,1,0,0,0,-89.45,89.45,-149.99,149.99,-134.67,134.67,-395.0,395.0,1.0,1.0,7.0,30.0,4950.91,16190.16,1,1,4,4,4,31700.0,12,1324.9950000000003,162.50214285714287,0.0,22500.0,0.0,0,0
2024-10-01,Expense,Professional Liability Insurance,-189.0,other,bank_transfer,paid,Progressive,Unknown,2024,10,4,1,1,275,40,0,1,0,1,0,19997,56,66,-0.8660254037844386,0.5000000000000001,0.7818314824680298,0.6234898018587336,-0.999832969770105,0.018276557681691223,1,1,Fall,0,0,1,0,189.0,-1.0,0,1,5.247024072160486,-5.247024072160486,13.74772708486752,-13.74772708486752,35721.0,-6751269.0,small,0.6023622047244095,Q3,691.5571428571428,1395.8994363696636,4840.9,-189.0,2950.0,2.018487482614317,502.2807142857143,1539.1643883987294,7031.93,-1200.0,4200.0,3.0643509587811897,466.70533333333333,1317.6233572289932,14001.16,-1200.0,4200.0,2.8232446966444065,438.1861403508772,1203.545912921413,57.0,-0.5048134382466719,0.5048134382466719,-627.1861403508772,627.1861403508772,24976.609999999993,38423.39000000001,24976.609999999993,12,1,0,0,4,3.149606299212598,10,7.874015748031496,99,77.95275590551181,100,78.74015748031496,0,1,0,0,0,0,0,0,0,0,0,0,0,0,0,1,0,0,2500.0,2500.0,-89.45,89.45,-149.99,149.99,-78.99,78.99,1.0,1.0,7.0,30.0,4840.9,14001.16,1,1,19,12,2,-334.0,2,-49.77499999999999,-45.850357142857256,189.0,1890.0,0.0,120,12
2024-10-02,Expense,Bad Debt Write-off,-500.0,bad_debts,other,written_off,Old Client,Unknown,2024,10,4,2,2,276,40,0,0,0,0,0,19998,57,65,-0.8660254037844386,0.5000000000000001,0.9749279121818236,-0.22252093395631434,-0.9993706508539969,0.03547255575312556,1,2,Fall,0,0,1,0,500.0,-1.0,0,1,6.2166061010848646,-6.2166061010848646,22.360679774997898,-22.360679774997898,250000.0,-125000000.0,medium,0.7637795275590551,Q4,626.6985714285713,1445.5447425039995,4386.889999999999,-500.0,2950.0,2.306602900352641,469.7807142857143,1556.3175011914616,6576.93,-1200.0,4200.0,3.312859497771827,452.55533333333335,1325.9002658824409,13576.66,-1200.0,4200.0,2.9298080659361894,422.0105172413793,1199.285549751846,58.0,-0.7794538859558381,0.7794538859558381,-922.0105172413794,922.0105172413794,24476.609999999993,38923.39000000001,24476.609999999993,1,4,2,0,1,0.7874015748031495,1,0.7874015748031495,1,0.7874015748031495,100,78.74015748031496,0,0,0,0,0,0,0,0,0,0,0,0,0,0,0,0,1,0,-189.0,189.0,2500.0,2500.0,-89.45,89.45,-45.99,45.99,1.0,1.0,7.0,30.0,4386.889999999999,13576.66,1,1,-1,-1,9,-500.0,1,-1499.9999999999995,-278.88107142857143,1000.0,5000.0,0.0,10,2
2024-10-03,Income,Mobile App Updates,1320.0,Unknown,Unknown,received,AppCorp,Unknown,2024,10,4,3,3,277,40,0,0,0,0,0,19999,58,64,-0.8660254037844386,0.5000000000000001,0.43388373911755823,-0.900968867902419,-0.9986126020839734,0.052658056924614005,1,3,Fall,0,0,1,0,1320.0,1.0,1,0,7.186144304522325,7.186144304522325,36.3318042491699,36.3318042491699,1742400.0,2299968000.0,xlarge,0.8031496062992126,Q4,393.84142857142854,1098.5579802242062,2756.89,-500.0,2500.0,2.7893408375268667,649.7807142857143,1492.7702522670045,9096.93,-500.0,4200.0,2.297344657124773,497.4216666666667,1331.9081323116159,14922.65,-1200.0,4200.0,2.677623878422966,437.2306779661017,1194.6360711745049,59.0,0.8277667405093787,0.8277667405093787,882.7693220338983,882.7693220338983,25796.609999999993,40243.39000000001,25796.609999999993,0,0,1,1,27,21.25984251968504,27,21.25984251968504,27,21.25984251968504,27,21.25984251968504,0,0,1,1,0,0,0,0,0,0,0,0,0,0,1,0,0,0,-500.0,500.0,-189.0,189.0,2500.0,2500.0,2950.0,2950.0,1.0,1.0,7.0,30.0,2756.89,14922.65,1,1,3,3,3,33020.0,13,754.5000000000001,127.30142857142856,3960.0,13200.0,0.0,0,0
2024-10-04,Expense,Fuel for Client Visit,-58.75,fuel,credit_card,paid,Texaco,https://tmsappstorage.blob.core.windows.net/receipts/00998877-6655-4433-2211-009988776655.png,2024,10,4,4,4,278,40,0,0,0,0,0,20000,59,63,-0.8660254037844386,0.5000000000000001,-0.433883739117558,-0.9009688679024191,-0.9975590477788613,0.06982797572987089,1,4,Fall,0,0,1,0,58.75,-1.0,0,1,4.09016919081162,-4.09016919081162,7.664854858377946,-7.664854858377946,3451.5625,-202779.296875,small,0.2283464566929134,Q1,404.6871428571429,1092.8303527951982,2832.81,-500.0,2500.0,2.700432598573991,659.155,1487.493761537015,9228.17,-500.0,4200.0,2.2566676449955096,501.96333333333337,1329.6960927202138,15058.900000000001,-1200.0,4200.0,2.648990482811255,428.96433333333334,1186.1982195923053,60.0,-0.389791192863653,0.389791192863653,-487.71433333333334,487.71433333333334,25737.859999999993,40302.14000000001,25737.859999999993,5,3,0,0,9,7.086614173228346,88,69.29133858267717,99,77.95275590551181,100,78.74015748031496,0,1,0,0,0,1,0,0,0,0,0,0,0,1,0,0,0,0,1320.0,1320.0,-500.0,500.0,-189.0,189.0,-134.67,134.67,1.0,1.0,7.0,30.0,2832.81,15058.900000000001,1,1,17,5,3,-553.77,5,220.62499999999991,3.3078571428571895,235.0,587.5,0.0,50,20
2024-10-05,Expense,Business Lunch,-62.3,meals_entertainment,credit_card,paid,Applebees,https://tmsappstorage.blob.core.windows.net/receipts/33221100-9988-7766-5544-332211009988.png,2024,10,4,5,5,279,40,1,0,0,0,0,20001,60,62,-0.8660254037844386,0.5000000000000001,-0.9749279121818236,-0.2225209339563146,-0.9962102997023297,0.0869772313136861,0,5,Fall,0,0,1,0,62.3,-1.0,0,1,4.147885329150131,-4.147885329150131,7.893034904268446,-7.893034904268446,3881.2899999999995,-241804.36699999997,small,0.23622047244094488,Q1,417.21428571428567,1085.8929377530303,2920.4999999999995,-500.0,2500.0,2.602722329830924,354.70500000000004,1090.1498395933397,4965.870000000001,-500.0,2950.0,3.0733985694967356,502.1530000000001,1329.6123948915756,15064.590000000002,-1200.0,4200.0,2.647823262813476,420.9108196721312,1177.9522556457812,61.0,-0.39292615617351645,0.39292615617351645,-483.2108196721312,483.2108196721312,25675.559999999994,40364.44000000001,25675.559999999994,10,3,0,0,9,7.086614173228346,88,69.29133858267717,99,77.95275590551181,100,78.74015748031496,0,1,0,0,0,0,1,0,0,0,0,0,0,1,0,0,0,0,-58.75,58.75,1320.0,1320.0,-500.0,500.0,-149.99,149.99,1.0,1.0,7.0,30.0,2920.4999999999995,15064.590000000002,1,2,8,1,1,-378.07,5,-691.15,-125.96607142857152,311.5,623.0,62.3,100,50
2024-10-06,Expense,Computer Monitor,-345.99,computer_equipment,credit_card,paid,Dell,https://tmsappstorage.blob.core.windows.net/receipts/66554433-2211-0099-8877-665544332211.png,2024,10,4,6,6,280,40,1,0,0,0,0,20002,61,61,-0.8660254037844386,0.5000000000000001,-0.7818314824680299,0.6234898018587334,-0.9945667569706337,0.1041007489354256,0,5,Fall,0,0,1,0,345.99,-1.0,0,1,5.849295961087796,-5.849295961087796,18.600806434130753,-18.600806434130753,119709.0801,-41418144.623799,medium,0.7165354330708661,Q3,380.5657142857143,1109.9062342056525,2663.96,-500.0,2500.0,2.9164640758268017,337.13357142857143,1099.9807730669809,4719.87,-500.0,2950.0,3.262744699099283,375.61999999999995,1215.097996746169,11268.599999999999,-1200.0,4200.0,3.234912935270138,408.54145161290324,1172.309908276016,62.0,-0.6434494636031414,0.6434494636031414,-754.5314516129033,754.5314516129033,25329.569999999992,40710.43000000001,25329.569999999992,2,3,0,0,5,3.937007874015748,88,69.29133858267717,99,77.95275590551181,100,78.74015748031496,0,1,0,0,0,0,0,0,0,0,1,0,0,1,0,0,0,0,-62.3,62.3,-58.75,58.75,1320.0,1320.0,-89.45,89.45,1.0,1.0,7.0,30.0,2663.96,11268.599999999999,1,3,16,1,4,-571.97,3,-143.62000000000003,-280.11857142857144,2075.94,3459.9,345.99,20,12
2024-10-07,Expense,Office Cleaning Service,-150.0,maintenance,credit_card,paid,CleanPro,https://tmsappstorage.blob.core.windows.net/receipts/99887766-5544-3322-1100-998877665544.png,2024,10,4,7,0,281,41,0,0,0,0,0,20003,62,60,-0.8660254037844386,0.5000000000000001,0.0,1.0,-0.9926289059345095,0.121193461470736,1,5,Fall,0,0,1,0,150.0,-1.0,0,1,5.017279836814924,-5.017279836814924,12.24744871391589,-12.24744871391589,22500.0,-3375000.0,small,0.5236220472440944,Q3,1.9942857142857113,602.4443393890476,13.95999999999998,-500.0,1320.0,302.08527046728796,354.63357142857143,1089.3343826717667,4964.87,-500.0,2950.0,3.071718163296266,373.60166666666663,1215.947128765186,11208.05,-1200.0,4200.0,3.2546619494876974,399.67571428571426,1164.9446785628843,63.0,-0.4703729962509887,0.4703729962509887,-549.6757142857143,549.6757142857143,25179.569999999992,40860.43000000001,25179.569999999992,9,3,0,0,3,2.3622047244094486,88,69.29133858267717,99,77.95275590551181,100,78.74015748031496,0,1,0,0,0,0,0,0,0,0,0,0,0,1,0,0,0,0,-345.99,345.99,-62.3,62.3,-58.75,58.75,2500.0,2500.0,1.0,1.0,7.0,30.0,13.95999999999998,11208.05,1,4,47,1,2,-275.0,2,-43.85000000000003,-34.188571428571414,0.0,1500.0,0.0,90,0
2024-10-08,Income,Database Optimization,2100.0,Unknown,Unknown,received,DataCorp,Unknown,2024,10,4,8,1,282,41,0,0,0,0,0,20004,63,59,-0.8660254037844386,0.5000000000000001,0.7818314824680298,0.6234898018587336,-0.9903973200352558,0.1382503109109819,1,6,Fall,0,0,1,0,2100.0,1.0,1,0,7.650168700845001,7.650168700845001,45.8257569495584,45.8257569495584,4410000.0,9261000000.0,xlarge,0.8937007874015748,Q4,328.9942857142857,982.7072514548298,2302.96,-500.0,2100.0,2.987004012307556,510.27571428571434,1174.9164965399702,7143.860000000001,-500.0,2950.0,2.3025130603846633,444.2683333333333,1253.312999663178,13328.05,-1200.0,4200.0,2.821072099061404,426.24328125,1175.0439887220903,64.0,1.516575580423043,1.516575580423043,1673.75671875,1673.75671875,27279.569999999992,42960.43000000001,27279.569999999992,0,0,1,1,27,21.25984251968504,27,21.25984251968504,27,21.25984251968504,27,21.25984251968504,0,0,1,1,0,0,0,0,0,0,0,0,0,0,1,0,0,0,-150.0,150.0,-345.99,345.99,-62.3,62.3,-189.0,189.0,1.0,1.0,7.0,30.0,2302.96,13328.05,1,1,5,5,5,35120.0,14,1222.9950000000001,163.3128571428571,2100.0,21000.0,0.0,0,0
2024-10-09,Expense,Video Conferencing Software,-14.99,software,credit_card,paid,Zoom,https://tmsappstorage.blob.core.windows.net/receipts/22110099-8877-6655-4433-221100998877.png,2024,10,4,9,2,283,41,0,0,0,0,0,20005,64,58,-0.8660254037844386,0.5000000000000001,0.9749279121818236,-0.22252093395631434,-0.9878726596350429,0.15526624985999563,1,7,Fall,0,0,1,0,14.99,-1.0,0,1,2.771963526845863,-2.771963526845863,3.871692136521188,-3.871692136521188,224.70010000000002,-3368.254499,micro,0.031496062992125984,Q1,398.2814285714286,930.212337613096,2787.9700000000003,-345.99,2100.0,2.335565434094223,512.49,1173.8161939326196,7174.860000000001,-500.0,2950.0,2.2904177524100366,447.9576666666666,1251.7393547702234,13438.73,-1200.0,4200.0,2.7943251068446724,419.45507692307694,1167.1116811319985,65.0,-0.3511472507679838,0.3511472507679838,-434.44507692307695,434.44507692307695,27264.57999999999,42975.420000000006,27264.57999999999,16,3,0,0,15,11.811023622047244,88,69.29133858267717,99,77.95275590551181,100,78.74015748031496,0,1,0,0,1,0,0,0,0,0,0,0,0,1,0,0,0,0,2100.0,2100.0,-150.0,150.0,-345.99,345.99,-500.0,500.0,1.0,1.0,7.0,30.0,2787.9700000000003,13438.73,1,1,11,2,14,-715.9399999999999,7,67.50499999999991,8.029642857142832,29.98,149.9,0.0,160,32
2024-10-10,Expense,Networking Event,-95.0,entertainment,credit_card,paid,TechMeetup,https://tmsappstorage.blob.core.windows.net/receipts/55443322-1100-9988-7766-554433221100.png,2024,10,4,10,3,284,41,0,0,0,0,0,20006,65,57,-0.8660254037844386,0.5000000000000001,0.43388373911755823,-0.900968867902419,-0.9850556718215013,0.172236243027682,1,8,Fall,0,0,1,0,95.0,-1.0,0,1,4.564348191467836,-4.564348191467836,9.746794344808963,-9.746794344808963,9025.0,-857375.0,small,0.4251968503937008,Q2,196.13857142857142,846.512380130549,1372.97,-345.99,2100.0,4.315889393733179,294.99000000000007,947.7617171647505,4129.860000000001,-500.0,2500.0,3.212860494134548,445.99066666666664,1252.5721476527424,13379.72,-1200.0,4200.0,2.808516503303677,411.66030303030306,1159.8291203329113,66.0,-0.42180314215451237,0.42180314215451237,-506.66030303030306,506.66030303030306,27169.57999999999,43070.420000000006,27169.57999999999,3,3,0,0,4,3.149606299212598,88,69.29133858267717,99,77.95275590551181,100,78.74015748031496,0,1,0,0,0,0,0,0,0,0,0,0,0,1,0,0,0,0,-14.99,14.99,2100.0,2100.0,-150.0,150.0,1320.0,1320.0,1.0,1.0,7.0,30.0,1372.97,13379.72,1,2,38,1,3,-327.28,3,-1097.5,86.85214285714287,285.0,950.0,0.0,30,9
2024-10-11,Expense,Business Banking Fees,-25.0,other,bank_transfer,paid,Chase Bank,Unknown,2024,10,4,11,4,285,41,0,0,0,0,0,20007,66,56,-0.8660254037844386,0.5000000000000001,-0.433883739117558,-0.9009688679024191,-0.981947190186646,0.18915526872004093,1,9,Fall,0,0,1,0,25.0,-1.0,0,1,3.258096538021482,-3.258096538021482,5.0,-5.0,625.0,-15625.0,micro,0.09055118110236221,Q1,200.96,844.9132715847238,1406.72,-345.99,2100.0,4.204385308443092,302.8235714285714,944.3844686241779,4239.53,-500.0,2500.0,3.1185962974052526,356.82399999999996,1183.5776681610953,10704.72,-1200.0,4200.0,3.3169788695858333,405.1429850746269,1152.24457900855,67.0,-0.3599869642135425,0.3599869642135425,-430.1429850746269,430.1429850746269,27144.57999999999,43095.420000000006,27144.57999999999,12,1,0,0,4,3.149606299212598,10,7.874015748031496,99,77.95275590551181,100,78.74015748031496,0,1,0,0,0,0,0,0,0,0,0,0,0,0,0,1,0,0,-95.0,95.0,-14.99,14.99,2100.0,2100.0,-58.75,58.75,1.0,1.0,7.0,30.0,1406.72,10704.72,1,1,10,10,2,-359.0,3,-5.004999999999997,26.746071428571433,100.0,250.0,0.0,120,48
2024-10-12,Expense,Project Management Tool,-19.99,software,credit_card,paid,Trello,https://tmsappstorage.blob.core.windows.net/receipts/88776655-4433-2211-0099-887766554433.png,2024,10,4,12,5,286,41,1,0,0,0,0,20008,67,55,-0.8660254037844386,0.5000000000000001,-0.9749279121818236,-0.2225209339563146,-0.9785481345802031,0.20601832032517084,0,10,Fall,0,0,1,0,19.99,-1.0,0,1,3.0440461338325413,-3.0440461338325413,4.471017781221631,-4.471017781221631,399.60009999999994,-7988.005998999998,micro,0.07086614173228346,Q1,207.00428571428571,842.8649516353373,1449.03,-345.99,2100.0,4.071727059789902,312.10928571428576,940.219599884592,4369.530000000001,-500.0,2500.0,3.0124691667946633,360.991,1181.9689497565582,10829.73,-1200.0,4200.0,3.274233844490744,398.8910294117647,1144.7748899017968,68.0,-0.35556269204948165,0.35556269204948165,-418.8810294117647,418.8810294117647,27124.58999999999,43115.41,27124.58999999999,16,3,0,0,15,11.811023622047244,88,69.29133858267717,99,77.95275590551181,100,78.74015748031496,0,1,0,0,1,0,0,0,0,0,0,0,0,1,0,0,0,0,-25.0,25.0,-95.0,95.0,-14.99,14.99,-62.3,62.3,1.0,1.0,7.0,30.0,1449.03,10829.73,1,1,3,2,1,-735.93,8,37.504999999999995,-34.53571428571428,99.94999999999999,199.89999999999998,19.99,160,80
2024-10-13,Income,E-learning Platform Development,3850.0,Unknown,Unknown,received,EduTech Solutions,Unknown,2024,10,4,13,6,287,41,1,0,0,0,0,20009,68,54,-0.8660254037844386,0.5000000000000001,-0.7818314824680299,0.6234898018587334,-0.9748595108374125,0.22282040779479959,0,10,Fall,0,0,1,0,3850.0,1.0,1,0,8.25608813381491,8.25608813381491,62.048368229954285,62.048368229954285,14822500.0,57066625000.0,xlarge,0.9921259842519685,Q4,806.4314285714287,1565.9370334981397,5645.02,-150.0,3850.0,1.9418105222810507,593.4985714285714,1322.5578211228371,8308.98,-500.0,3850.0,2.228409443243301,489.7493333333333,1339.7195738788114,14692.48,-1200.0,4200.0,2.7355209751086504,448.9071014492754,1209.8959724656222,69.0,3.06198002894729,3.06198002894729,3401.0928985507244,3401.0928985507244,30974.58999999999,46965.41,30974.58999999999,0,0,1,1,27,21.25984251968504,27,21.25984251968504,27,21.25984251968504,27,21.25984251968504,0,0,1,1,0,0,0,0,0,0,0,0,0,0,1,0,0,0,-19.99,19.99,-25.0,25.0,-95.0,95.0,-345.99,345.99,1.0,1.0,7.0,30.0,5645.02,14692.48,1,1,5,5,5,38970.0,15,1937.5000000000005,276.7860714285714,23100.0,38500.0,3850.0,0,0
2024-10-14,Expense,Grocery Shopping,-156.78,food,credit_card,paid,Kroger,https://tmsappstorage.blob.core.windows.net/receipts/11009988-7766-5544-3322-110099887766.png,2024,10,4,14,0,288,42,0,0,0,0,0,20010,69,53,-0.8660254037844386,0.5000000000000001,0.0,1.0,-0.9708824104813836,0.23955655912092708,1,10,Fall,0,0,1,0,156.78,-1.0,0,1,5.061201657666944,-5.061201657666944,12.521182052825523,-12.521182052825523,24579.9684,-3853647.445752,small,0.547244094488189,Q3,805.4628571428572,1566.6291503811012,5638.24,-156.78,3850.0,1.9450048335416208,403.72857142857146,1214.1176780428918,5652.200000000001,-500.0,3850.0,3.007262215172939,485.85633333333334,1341.4805166050382,14575.69,-1200.0,4200.0,2.761064175908732,440.2544285714286,1203.2763125355245,70.0,-0.47636033462869976,0.47636033462869976,-597.0344285714286,597.0344285714286,30817.80999999999,47122.19,30817.80999999999,4,3,0,0,3,2.3622047244094486,88,69.29133858267717,99,77.95275590551181,100,78.74015748031496,0,1,0,0,0,0,0,0,0,0,0,0,0,1,0,0,0,0,3850.0,3850.0,-19.99,19.99,-25.0,25.0,-150.0,150.0,1.0,1.0,7.0,30.0,5638.24,14575.69,1,1,-1,2,4,-156.78,1,-68.39500000000011,36.951785714285656,0.0,1567.8,0.0,40,0
2024-10-15,Expense,Vehicle Fuel,-72.35,fuel,credit_card,paid,Mobil,https://tmsappstorage.blob.core.windows.net/receipts/44332211-0099-8877-6655-443322110099.png,2024,10,4,15,1,289,42,0,0,0,0,0,20011,70,52,-0.8660254037844386,0.5000000000000001,0.7818314824680298,0.6234898018587336,-0.9666180104000972,0.2562218218071163,1,11,Fall,0,0,1,0,72.35,-1.0,0,1,4.295242504588991,-4.295242504588991,8.50588031893231,-8.50588031893231,5234.522499999999,-378717.7028749999,small,0.29133858267716534,Q2,495.1271428571428,1480.232671910223,3465.89,-156.78,3850.0,2.9896011423823494,412.0607142857143,1210.130770813089,5768.85,-500.0,3850.0,2.9367778311766197,486.111,1341.3701128332982,14583.33,-1200.0,4200.0,2.759390577117774,433.03464788732396,1196.198504943092,71.0,-0.40180119314932716,0.40180119314932716,-505.3846478873239,505.3846478873239,30745.459999999992,47194.54,30745.459999999992,5,3,0,0,9,7.086614173228346,88,69.29133858267717,99,77.95275590551181,100,78.74015748031496,0,1,0,0,0,1,0,0,0,0,0,0,0,1,0,0,0,0,-156.78,156.78,3850.0,3850.0,-19.99,19.99,2100.0,2100.0,1.0,1.0,7.0,30.0,3465.89,14583.33,1,2,11,1,1,-626.12,6,-1961.175,127.83428571428567,72.35,723.5,0.0,50,5
2024-10-16,Expense,Office Chair Repair,-85.0,repairs,credit_card,paid,Furniture Fix,https://tmsappstorage.blob.core.windows.net/receipts/77665544-3322-1100-9988-776655443322.png,2024,10,4,16,2,290,42,0,0,0,0,0,20012,71,51,-0.8660254037844386,0.5000000000000001,0.9749279121818236,-0.22252093395631434,-0.9620675724981452,0.27281126433401914,1,12,Fall,0,0,1,0,85.0,-1.0,0,1,4.454347296253507,-4.454347296253507,9.219544457292887,-9.219544457292887,7225.0,-614125.0,small,0.3543307086614173,Q2,485.12571428571425,1484.4842190904465,3395.8799999999997,-156.78,3850.0,3.0599990381383106,441.7035714285715,1191.002392735484,6183.85,-345.99,3850.0,2.6963838867852186,420.77766666666673,1318.9342797558406,12623.330000000002,-1200.0,4200.0,3.1345158838971345,425.83972222222224,1189.3126971371964,72.0,-0.4129722595915167,0.4129722595915167,-510.83972222222224,510.83972222222224,30660.459999999992,47279.54,30660.459999999992,15,3,0,0,3,2.3622047244094486,88,69.29133858267717,99,77.95275590551181,100,78.74015748031496,0,1,0,0,0,0,0,0,0,0,0,0,0,1,0,0,0,0,-72.35,72.35,-156.78,156.78,3850.0,3850.0,-14.99,14.99,1.0,1.0,7.0,30.0,3395.8799999999997,12623.330000000002,1,3,71,1,1,-260.0,2,35.889999999999986,-7.196071428571373,170.0,850.0,0.0,150,30
2024-10-17,Expense,SSL Certificate,-99.0,software,credit_card,paid,DigiCert,https://tmsappstorage.blob.core.windows.net/receipts/00998877-6655-4433-2211-009988776655.png,2024,10,4,17,3,291,42,0,0,0,0,0,20013,72,50,-0.8660254037844386,0.5000000000000001,0.43388373911755823,-0.900968867902419,-0.957232443323312,0.28931997761869527,1,13,Fall,0,0,1,0,99.0,-1.0,0,1,4.605170185988092,-4.605170185988092,9.9498743710662,-9.9498743710662,9801.0,-970299.0,small,0.4330708661417323,Q2,484.55428571428564,1484.7454944855833,3391.8799999999997,-156.78,3850.0,3.064146862919409,340.3464285714286,1170.7150032063382,4764.85,-345.99,3850.0,3.439774608831072,420.55933333333337,1319.0227070538547,12616.78,-1200.0,4200.0,3.136353428657362,418.65013698630133,1182.6211263762245,73.0,-0.42533549517971064,0.42533549517971064,-517.6501369863013,517.6501369863013,30561.459999999992,47378.54,30561.459999999992,16,3,0,0,15,11.811023622047244,88,69.29133858267717,99,77.95275590551181,100,78.74015748031496,0,1,0,0,1,0,0,0,0,0,0,0,0,1,0,0,0,0,-85.0,85.0,-72.35,72.35,-156.78,156.78,-95.0,95.0,1.0,1.0,7.0,30.0,3391.8799999999997,12616.78,1,4,5,1,1,-834.93,9,-13.325000000000008,-152.65607142857138,297.0,990.0,0.0,160,48
2024-10-18,Income,WordPress Development,1425.0,Unknown,Unknown,received,BlogCorp,Unknown,2024,10,4,18,4,292,42,0,0,0,0,0,20014,73,49,-0.8660254037844386,0.5000000000000001,-0.433883739117558,-0.9009688679024191,-0.9521140536681102,0.3057430764672831,1,14,Fall,0,0,1,0,1425.0,1.0,1,0,7.262628600974241,7.262628600974241,37.749172176353746,37.749172176353746,2030625.0,2893640625.0,xlarge,0.8110236220472441,Q4,691.6971428571427,1502.8445544446074,4841.879999999999,-156.78,3850.0,2.17269157457687,446.3285714285715,1198.6338842382002,6248.6,-345.99,3850.0,2.685541461981052,469.55933333333337,1328.402355307212,14086.78,-1200.0,4200.0,2.8290404662539173,432.24945945945944,1180.304876020856,74.0,0.9204910074208335,0.9204910074208335,992.7505405405406,992.7505405405406,31986.459999999992,48803.54,31986.459999999992,0,0,1,1,27,21.25984251968504,27,21.25984251968504,27,21.25984251968504,27,21.25984251968504,0,0,1,1,0,0,0,0,0,0,0,0,0,0,1,0,0,0,-99.0,99.0,-85.0,85.0,-72.35,72.35,-25.0,25.0,1.0,1.0,7.0,30.0,4841.879999999999,14086.78,1,1,5,5,5,40395.0,16,755.0000000000002,-124.6875000000001,5700.0,14250.0,0.0,0,0
2024-10-19,Expense,Parking Downtown,-15.0,travel,credit_card,paid,SpotHero,https://tmsappstorage.blob.core.windows.net/receipts/33221100-9988-7766-5544-332211009988.png,2024,10,4,19,5,293,42,1,0,0,0,0,20015,74,48,-0.8660254037844386,0.5000000000000001,-0.9749279121818236,-0.2225209339563146,-0.9467139181463862,0.3220757010206104,0,15,Fall,0,0,1,0,15.0,-1.0,0,1,2.772588722239781,-2.772588722239781,3.872983346207417,-3.872983346207417,225.0,-3375.0,micro,0.03937007874015748,Q1,692.4099999999999,1502.4518425005626,4846.869999999999,-156.78,3850.0,2.169887555784236,449.7071428571429,1197.1556890745312,6295.900000000001,-345.99,3850.0,2.6620784394675003,509.05933333333337,1294.2244860704686,15271.78,-500.0,4200.0,2.5423843574301133,426.28613333333334,1173.4397105091134,75.0,-0.3511560816505468,0.3511560816505468,-441.28613333333334,441.28613333333334,31971.459999999992,48818.54,31971.459999999992,20,3,0,0,6,4.724409448818897,88,69.29133858267717,99,77.95275590551181,100,78.74015748031496,0,1,0,0,0,0,0,0,1,0,0,0,0,1,0,0,0,0,1425.0,1425.0,-99.0,99.0,-85.0,85.0,-19.99,19.99,1.0,1.0,7.0,30.0,4846.869999999999,15271.78,1,1,41,2,7,-259.0,4,41.99999999999999,-302.074642857143,75.0,150.0,15.0,200,100
2024-10-20,Expense,Lunch Meeting with Client,-78.45,meals_entertainment,credit_card,paid,Cheesecake Factory,https://tmsappstorage.blob.core.windows.net/receipts/66554433-2211-0099-8877-665544332211.png,2024,10,4,20,6,294,42,1,0,0,0,0,20016,75,47,-0.8660254037844386,0.5000000000000001,-0.7818314824680299,0.6234898018587334,-0.9410336347451197,0.3383130181923076,0,15,Fall,0,0,1,0,78.45,-1.0,0,1,4.375127892982725,-4.375127892982725,8.857200460642177,-8.857200460642177,6154.4025,-482812.87612500007,small,0.31496062992125984,Q2,131.2028571428571,572.0351920034971,918.4199999999998,-156.78,1425.0,4.359929383097581,468.81714285714287,1185.5562149824511,6563.4400000000005,-156.78,3850.0,2.5288243679769016,512.7773333333333,1292.3058265482578,15383.32,-500.0,4200.0,2.520208563330135,419.64486842105265,1167.0275763019981,76.0,-0.40718803151275446,0.40718803151275446,-498.09486842105264,498.09486842105264,31893.00999999999,48896.99,31893.00999999999,10,3,0,0,9,7.086614173228346,88,69.29133858267717,99,77.95275590551181,100,78.74015748031496,0,1,0,0,0,0,1,0,0,0,0,0,0,1,0,0,0,0,-15.0,15.0,1425.0,1425.0,-99.0,99.0,3850.0,3850.0,1.0,1.0,7.0,30.0,918.4199999999998,15383.32,1,2,15,1,3,-456.52,6,-751.7250000000001,66.41749999999999,470.70000000000005,784.5,78.45,100,60
2024-10-21,Expense,Business Phone Service,-45.0,telephone,credit_card,paid,RingCentral,https://tmsappstorage.blob.core.windows.net/receipts/99887766-5544-3322-1100-998877665544.png,2024,10,4,21,0,295,43,0,0,0,0,0,20017,76,46,-0.8660254037844386,0.5000000000000001,0.0,1.0,-0.9350748843515574,0.3544502230989869,1,15,Fall,0,0,1,0,45.0,-1.0,0,1,3.828641396489095,-3.828641396489095,6.708203932499369,-6.708203932499369,2025.0,-91125.0,micro,0.16929133858267717,Q1,147.17142857142855,564.1621987935921,1030.1999999999998,-99.0,1425.0,3.8333676873957923,476.31714285714287,1181.6660957988254,6668.4400000000005,-156.78,3850.0,2.4808388980306573,371.27733333333333,1091.4465755416572,11138.32,-500.0,3850.0,2.9397069994621914,413.6105194805195,1160.5329612384041,77.0,-0.37764872933953386,0.37764872933953386,-458.6105194805195,458.6105194805195,31848.00999999999,48941.99,31848.00999999999,18,3,0,0,6,4.724409448818897,88,69.29133858267717,99,77.95275590551181,100,78.74015748031496,0,1,0,0,0,0,0,0,0,1,0,0,0,1,0,0,0,0,-78.45,78.45,-15.0,15.0,1425.0,1425.0,-156.78,156.78,1.0,1.0,7.0,30.0,1030.1999999999998,11138.32,1,3,29,1,2,-360.65,4,-15.000000000000005,6.3982142857143,0.0,450.0,0.0,180,0
2024-10-22,Expense,Computer Mouse & Keyboard,-125.99,computer_equipment,credit_card,paid,Logitech,https://tmsappstorage.blob.core.windows.net/receipts/22110099-8877-6655-4433-221100998877.png,2024,10,4,22,1,296,43,0,0,0,0,0,20018,77,45,-0.8660254037844386,0.5000000000000001,0.7818314824680298,0.6234898018587336,-0.9288394302558068,0.3704825404820963,1,16,Fall,0,0,1,0,125.99,-1.0,0,1,4.844108343200942,-4.844108343200942,11.224526716080282,-11.224526716080282,15873.480099999999,-1999899.7577989998,small,0.4881889763779528,Q2,139.5085714285714,567.992134934649,976.5599999999997,-125.99,1425.0,4.071378045939363,317.3178571428572,1092.8033449392617,4442.450000000001,-156.78,3850.0,3.4438759759028605,370.41066666666666,1091.843941081052,11112.32,-500.0,3850.0,2.947657935735432,406.6925641025641,1154.590100433619,78.0,-0.449170047217236,0.449170047217236,-532.6825641025641,532.6825641025641,31722.01999999999,49067.979999999996,31722.01999999999,2,3,0,0,5,3.937007874015748,88,69.29133858267717,99,77.95275590551181,100,78.74015748031496,0,1,0,0,0,0,0,0,0,0,1,0,0,1,0,0,0,0,-45.0,45.0,-78.45,78.45,-15.0,15.0,-72.35,72.35,1.0,1.0,7.0,30.0,976.5599999999997,11112.32,1,4,16,1,2,-697.96,4,-23.770000000000007,-54.2292857142857,125.99,1259.8999999999999,0.0,20,2
2024-10-23,Income,UI/UX Design Project,1675.0,Unknown,Unknown,received,DesignStudio,Unknown,2024,10,4,23,2,297,43,0,0,0,0,0,20019,78,44,-0.8660254037844386,0.5000000000000001,0.9749279121818236,-0.22252093395631434,-0.9223291176290545,0.3864052261209853,1,17,Fall,0,0,1,0,1675.0,1.0,1,0,7.424165281042028,7.424165281042028,40.92676385936225,40.92676385936225,2805625.0,4699421875.0,xlarge,0.8267716535433071,Q4,390.9371428571429,795.8754021979892,2736.56,-125.99,1675.0,2.0358142395510876,438.0314285714286,1145.3490069296454,6132.4400000000005,-156.78,3850.0,2.614764448900443,439.41066666666666,1107.1062372875156,13182.32,-500.0,3850.0,2.5195251760407475,422.747088607595,1156.0058933209198,79.0,1.141263071495726,1.141263071495726,1252.252911392405,1252.252911392405,33397.01999999999,50742.979999999996,33397.01999999999,0,0,1,1,27,21.25984251968504,27,21.25984251968504,27,21.25984251968504,27,21.25984251968504,0,0,1,1,0,0,0,0,0,0,0,0,0,0,1,0,0,0,-125.99,125.99,-45.0,45.0,-78.45,78.45,-85.0,85.0,1.0,1.0,7.0,30.0,2736.56,13182.32,1,1,5,5,5,42070.0,17,860.0000000000003,78.215,3350.0,16750.0,0.0,0,0
2024-10-24,Expense,Marketing Materials,-178.5,supplies,credit_card,paid,VistaPrint,https://tmsappstorage.blob.core.windows.net/receipts/55443322-1100-9988-7766-554433221100.png,2024,10,4,24,3,298,43,0,0,0,0,0,20020,79,43,-0.8660254037844386,0.5000000000000001,0.43388373911755823,-0.900968867902419,-0.9155458729775467,0.40221356823680365,1,18,Fall,0,0,1,0,178.5,-1.0,0,1,5.190175207928333,-5.190175207928333,13.360389215887388,-13.360389215887388,31862.25,-5687411.625,small,0.5905511811023622,Q3,379.58,804.5519765476114,2657.06,-178.5,1675.0,2.1195847424722363,432.06714285714287,1148.5511609275973,6048.9400000000005,-178.5,3850.0,2.658270085830966,436.09366666666665,1108.86065578821,13082.81,-500.0,3850.0,2.5427121294008166,415.23150000000004,1150.6313628261837,80.0,-0.49554101155552643,0.49554101155552643,-593.7315000000001,593.7315000000001,33218.51999999999,50921.479999999996,33218.51999999999,17,3,0,0,5,3.937007874015748,88,69.29133858267717,99,77.95275590551181,100,78.74015748031496,0,1,0,0,0,0,0,0,0,0,0,1,0,1,0,0,0,0,1675.0,1675.0,-125.99,125.99,-45.0,45.0,-99.0,99.0,1.0,1.0,7.0,30.0,2657.06,13082.81,1,1,36,2,2,-269.17,3,-26.255000000000038,-52.787142857142875,535.5,1785.0,0.0,170,51
2024-10-25,Expense,Accountant Fees,-450.0,professional_fees,bank_transfer,paid,CPA Services,Unknown,2024,10,4,25,4,299,43,0,0,0,0,0,20021,80,42,-0.8660254037844386,0.5000000000000001,-0.433883739117558,-0.9009688679024191,-0.9084917035725082,0.41790288888678667,1,19,Fall,0,0,1,0,450.0,-1.0,0,1,6.111467339502679,-6.111467339502679,21.213203435596427,-21.213203435596427,202500.0,-91125000.0,medium,0.7559055118110236,Q4,111.72285714285714,704.3781128228013,782.06,-450.0,1675.0,6.304691187069547,401.71000000000004,1167.0290117743757,5623.9400000000005,-450.0,3850.0,2.9051530003594026,422.62666666666667,1117.3383272153376,12678.8,-500.0,3850.0,2.643795139639408,404.5496296296297,1147.451705815374,81.0,-0.7352994731408596,0.7352994731408596,-854.5496296296296,854.5496296296296,32768.51999999999,51371.479999999996,32768.51999999999,13,1,0,0,3,2.3622047244094486,10,7.874015748031496,99,77.95275590551181,100,78.74015748031496,0,1,0,0,0,0,0,0,0,0,0,0,0,0,0,1,0,0,-178.5,178.5,1675.0,1675.0,-125.99,125.99,1425.0,1425.0,1.0,1.0,7.0,30.0,782.06,12678.8,1,1,70,14,19,-645.0,2,-1062.5,7.674999999999982,1800.0,4500.0,0.0,130,52
2024-10-26,Expense,Office Coffee Machine,-289.0,supplies,credit_card,paid,Keurig,https://tmsappstorage.blob.core.windows.net/receipts/88776655-4433-2211-0099-887766554433.png,2024,10,4,26,5,300,43,1,0,0,0,0,20022,81,41,-0.8660254037844386,0.5000000000000001,-0.9749279121818236,-0.2225209339563146,-0.9011686968561569,0.4334685453485363,0,20,Fall,0,0,1,0,289.0,-1.0,0,1,5.66988092298052,-5.66988092298052,17.0,-17.0,83521.0,-24137569.0,medium,0.6850393700787402,Q3,72.58,720.0331170393032,508.05999999999995,-450.0,1675.0,9.920544461825616,382.495,1176.6810453772082,5354.93,-450.0,3850.0,3.076330528182612,314.65999999999997,1016.654345691688,9439.8,-500.0,3850.0,3.2309615003231684,396.0917073170732,1142.9157993362232,82.0,-0.5931222638766289,0.5931222638766289,-685.0917073170732,685.0917073170732,32479.51999999999,51660.479999999996,32479.51999999999,17,3,0,0,5,3.937007874015748,88,69.29133858267717,99,77.95275590551181,100,78.74015748031496,0,1,0,0,0,0,0,0,0,0,0,1,0,1,0,0,0,0,-450.0,450.0,-178.5,178.5,1675.0,1675.0,-15.0,15.0,1.0,1.0,7.0,30.0,508.05999999999995,9439.8,1,1,2,2,1,-558.1700000000001,4,-55.25000000000006,-53.362857142857145,1445.0,2890.0,289.0,170,85
2024-10-27,Expense,Domain Registration,-12.99,software,credit_card,paid,GoDaddy,https://tmsappstorage.blob.core.windows.net/receipts/11009988-7766-5544-3322-110099887766.png,2024,10,4,27,6,301,43,1,0,0,0,0,20023,82,40,-0.8660254037844386,0.5000000000000001,-0.7818314824680299,0.6234898018587334,-0.8935790198239952,0.4489059314938798,0,20,Fall,0,0,1,0,12.99,-1.0,0,1,2.63834278867739,-2.63834278867739,3.6041642581880198,-3.6041642581880198,168.7401,-2191.933899,micro,0.023622047244094488,Q1,81.93142857142857,718.167361795021,573.52,-450.0,1675.0,8.765468567033663,106.56714285714288,624.2798053933648,1491.9400000000003,-450.0,1675.0,5.858088981800276,318.716,1015.0413485601943,9561.48,-500.0,3850.0,3.1847831566667324,391.16301204819274,1136.8125640726796,83.0,-0.34938107425538467,0.34938107425538467,-404.15301204819275,404.15301204819275,32466.529999999988,51673.469999999994,32466.529999999988,16,3,0,0,15,11.811023622047244,88,69.29133858267717,99,77.95275590551181,100,78.74015748031496,0,1,0,0,1,0,0,0,0,0,0,0,0,1,0,0,0,0,-289.0,289.0,-450.0,450.0,-178.5,178.5,-78.45,78.45,1.0,1.0,7.0,30.0,573.52,9561.48,1,2,10,1,6,-847.92,10,218.50500000000002,-84.10678571428572,77.94,129.9,12.99,160,96
2024-10-28,Income,API Development,2750.0,Unknown,Unknown,received,TechSolutions,Unknown,2024,10,4,28,0,302,44,0,0,0,0,0,20024,83,39,-0.8660254037844386,0.5000000000000001,0.0,1.0,-0.8857249183835637,0.4642104791518923,1,20,Fall,0,0,1,0,2750.0,1.0,1,0,7.919719760924575,7.919719760924575,52.44044240850758,52.44044240850758,7562500.0,20796875000.0,xlarge,0.9330708661417323,Q4,481.21714285714285,1230.2480034626396,3368.52,-450.0,2750.0,2.556534034008549,314.19428571428574,935.6728433322461,4398.72,-450.0,2750.0,2.978007194513732,415.3823333333333,1103.1316614691777,12461.47,-500.0,3850.0,2.6557019231338947,419.2444047619048,1158.8838761449736,84.0,2.0905829470177633,2.0905829470177633,2330.7555952380953,2330.7555952380953,35216.529999999984,54423.469999999994,35216.529999999984,0,0,1,1,27,21.25984251968504,27,21.25984251968504,27,21.25984251968504,27,21.25984251968504,0,0,1,1,0,0,0,0,0,0,0,0,0,0,1,0,0,0,-12.99,12.99,-289.0,289.0,-450.0,450.0,-45.0,45.0,1.0,1.0,7.0,30.0,3368.52,12461.47,1,1,5,5,5,44820.0,18,1519.5000000000002,183.62464285714285,0.0,27500.0,0.0,0,0
2024-10-29,Expense,Business Travel,-245.67,travel,credit_card,paid,United Airlines,https://tmsappstorage.blob.core.windows.net/receipts/44332211-0099-8877-6655-443322110099.png,2024,10,4,29,1,303,44,0,0,0,0,0,20025,84,38,-0.8660254037844386,0.5000000000000001,0.7818314824680298,0.6234898018587336,-0.8776087166898392,0.4793776594606945,1,21,Fall,0,0,1,0,245.67,-1.0,0,1,5.508051410952312,-5.508051410952312,15.673863595170145,-15.673863595170145,60353.74889999999,-14827105.492262999,medium,0.6614173228346457,Q3,464.11999999999995,1240.8786616882953,3248.8399999999997,-450.0,2750.0,2.6736160081192266,301.81428571428575,942.3037865026025,4225.400000000001,-450.0,2750.0,3.1221311617921224,410.175,1105.9619845457376,12305.25,-500.0,3850.0,2.696317387811879,411.42188235294117,1154.220477226425,85.0,-0.5548580497311685,0.5548580497311685,-657.0918823529412,657.0918823529412,34970.859999999986,54669.13999999999,34970.859999999986,20,3,0,0,6,4.724409448818897,88,69.29133858267717,99,77.95275590551181,100,78.74015748031496,0,1,0,0,0,0,0,0,1,0,0,0,0,1,0,0,0,0,2750.0,2750.0,-12.99,12.99,-289.0,289.0,-125.99,125.99,1.0,1.0,7.0,30.0,3248.8399999999997,12305.25,1,1,10,2,3,-504.66999999999996,5,-116.34000000000023,19.000000000000004,245.67,2456.7,0.0,200,20
2024-10-30,Expense,Web Hosting Service,-29.99,software,credit_card,paid,HostGator,https://tmsappstorage.blob.core.windows.net/receipts/77665544-3322-1100-9988-776655443322.png,2024,10,4,30,2,304,44,0,0,0,0,0,20026,85,37,-0.8660254037844386,0.5000000000000001,0.9749279121818236,-0.22252093395631434,-0.8692328164574792,0.49440298420761813,1,22,Fall,0,0,1,0,29.99,-1.0,0,1,3.433664571799657,-3.433664571799657,5.476312628037227,-5.476312628037227,899.4001,-26973.008998999994,micro,0.1141732283464567,Q1,220.54999999999998,1125.5597882535317,1543.85,-450.0,2750.0,5.103422299948002,305.7435714285715,940.6800396571302,4280.410000000001,-450.0,2750.0,3.076696053695749,325.842,1035.3147193749755,9775.26,-500.0,3850.0,3.1773519662136116,406.28918604651165,1148.3977137521192,86.0,-0.36439357461247734,0.36439357461247734,-436.27918604651165,436.27918604651165,34940.86999999999,54699.12999999999,34940.86999999999,16,3,0,0,15,11.811023622047244,88,69.29133858267717,99,77.95275590551181,100,78.74015748031496,0,1,0,0,1,0,0,0,0,0,0,0,0,1,0,0,0,0,-245.67,245.67,2750.0,2750.0,-12.99,12.99,1675.0,1675.0,1.0,1.0,7.0,30.0,1543.85,9775.26,1,2,3,1,3,-877.91,11,-1389.9949999999994,139.0425,59.98,299.9,0.0,160,32
2024-10-31,Expense,Halloween Office Decorations,-45.99,supplies,credit_card,paid,Party City,https://tmsappstorage.blob.core.windows.net/receipts/00998877-6655-4433-2211-009988776655.png,2024,10,4,31,3,305,44,0,0,1,0,0,20027,86,36,-0.8660254037844386,0.5000000000000001,0.43388373911755823,-0.900968867902419,-0.8605996962501181,0.5092820071573356,1,23,Fall,0,0,1,0,45.99,-1.0,0,1,3.849934813114724,-3.849934813114724,6.7815927332743895,-6.7815927332743895,2115.0801,-97272.53379900001,micro,0.20078740157480315,Q1,239.48,1118.8240311744,1676.36,-450.0,2750.0,4.6718892232102895,309.5300000000001,939.0307854869867,4333.420000000001,-450.0,2750.0,3.03373109387454,330.60900000000004,1033.189495906095,9918.27,-500.0,3850.0,3.125110011845095,401.0905747126437,1142.7306977875166,87.0,-0.37852298671327045,0.37852298671327045,-447.0805747126437,447.0805747126437,34894.87999999999,54745.11999999999,34894.87999999999,17,3,0,0,5,3.937007874015748,88,69.29133858267717,99,77.95275590551181,100,78.74015748031496,0,1,0,0,0,0,0,0,0,0,0,1,0,1,0,0,0,0,-29.99,29.99,-245.67,245.67,2750.0,2750.0,-178.5,178.5,1.0,1.0,7.0,30.0,1676.36,9918.27,1,3,5,1,1,-604.16,5,99.83999999999996,53.47750000000002,137.97,459.90000000000003,0.0,170,51
2024-11-01,Income,Monthly Retainer,2000.0,Unknown,Unknown,received,BigCorp Inc,Unknown,2024,11,4,1,4,306,44,0,1,0,0,0,20028,87,35,-0.5000000000000004,0.8660254037844384,-0.433883739117558,-0.9009688679024191,-0.8517119107469189,0.5240103253675756,1,1,Fall,0,0,1,0,2000.0,1.0,1,0,7.601402334583733,7.601402334583733,44.721359549995796,44.721359549995796,4000000.0,8000000000.0,xlarge,0.8740157480314961,Q4,589.4799999999999,1243.459641242932,4126.36,-289.0,2750.0,2.109417861917168,350.6014285714286,1002.0334724092659,4908.42,-450.0,2750.0,2.8580416129283397,413.94233333333335,1064.2393619426798,12418.27,-450.0,3850.0,2.570984594334025,419.26,1148.8581867017897,88.0,1.428266754793086,1.428266754793086,1580.74,1580.74,36894.87999999999,56745.11999999999,36894.87999999999,0,0,1,1,27,21.25984251968504,27,21.25984251968504,27,21.25984251968504,27,21.25984251968504,0,0,1,1,0,0,0,0,0,0,0,0,0,0,1,0,0,0,-45.99,45.99,-29.99,29.99,-245.67,245.67,-450.0,450.0,1.0,1.0,7.0,30.0,4126.36,12418.27,1,1,4,4,4,46820.0,19,1014.9950000000002,143.60750000000002,8000.0,22000.0,0.0,0,0
2024-11-02,Expense,Fuel Station,-68.9,fuel,credit_card,paid,Chevron,https://tmsappstorage.blob.core.windows.net/receipts/33221100-9988-7766-5544-332211009988.png,2024,11,4,2,5,307,44,1,0,0,0,0,20029,88,34,-0.5000000000000004,0.8660254037844384,-0.9749279121818236,-0.2225209339563146,-0.8425720899866032,0.5385835804920232,0,2,Fall,0,0,1,0,68.9,-1.0,0,1,4.247065649239764,-4.247065649239764,8.300602387778854,-8.300602387778854,4747.210000000001,-327082.7690000001,small,0.28346456692913385,Q2,620.9228571428572,1220.1070866624007,4346.46,-245.67,2750.0,1.9649898093245546,346.7514285714286,1003.6484814749796,4854.52,-450.0,2750.0,2.894432145845462,367.64566666666667,1053.6218642007937,11029.37,-450.0,3850.0,2.865862322691487,413.77505617977533,1143.4833108832252,89.0,-0.3987545386650936,0.3987545386650936,-482.6750561797753,482.6750561797753,36825.97999999999,56814.01999999999,36825.97999999999,5,3,0,0,9,7.086614173228346,88,69.29133858267717,99,77.95275590551181,100,78.74015748031496,0,1,0,0,0,1,0,0,0,0,0,0,0,1,0,0,0,0,2000.0,2000.0,-45.99,45.99,-29.99,29.99,-289.0,289.0,1.0,1.0,7.0,30.0,4346.46,11029.37,1,1,18,2,9,-695.02,7,-11.455000000000023,-52.430357142857126,344.5,757.9000000000001,68.9,55,25
2024-11-03,Expense,Equipment Maintenance,-175.0,maintenance,credit_card,paid,TechFix Pro,https://tmsappstorage.blob.core.windows.net/receipts/66554433-2211-0099-8877-665544332211.png,2024,11,4,3,6,308,44,1,0,0,0,0,20030,89,33,-0.5000000000000004,0.8660254037844384,-0.7818314824680299,0.6234898018587334,-0.8331829385891785,0.5529974600700271,0,2,Fall,0,0,1,0,175.0,-1.0,0,1,5.170483995038151,-5.170483995038151,13.228756555322953,-13.228756555322953,30625.0,-5359375.0,small,0.5787401574803149,Q3,597.7785714285714,1235.5744882365263,4184.45,-245.67,2750.0,2.066943425696492,339.855,1007.1206487556491,4757.97,-450.0,2750.0,2.963383351004543,363.77066666666667,1055.4563081694637,10913.12,-450.0,3850.0,2.9014332514518224,407.23311111111116,1138.7335937092123,90.0,-0.49245020265847794,0.49245020265847794,-582.2331111111112,582.2331111111112,36650.97999999999,56989.01999999999,36650.97999999999,9,3,0,0,3,2.3622047244094486,88,69.29133858267717,99,77.95275590551181,100,78.74015748031496,0,1,0,0,0,0,0,0,0,0,0,0,0,1,0,0,0,0,-68.9,68.9,2000.0,2000.0,-45.99,45.99,-12.99,12.99,1.0,1.0,7.0,30.0,4184.45,10913.12,1,2,27,1,1,-450.0,3,-1087.5000000000002,-228.26678571428585,1050.0,1925.0,175.0,99,54
2024-11-04,Expense,Professional Development,-89.99,training,credit_card,paid,Coursera,https://tmsappstorage.blob.core.windows.net/receipts/99887766-5544-3322-1100-998877665544.png,2024,11,4,4,0,309,45,0,0,0,0,0,20031,90,32,-0.5000000000000004,0.8660254037844384,0.0,1.0,-0.8235472349556007,0.5672476988027229,1,2,Fall,0,0,1,0,89.99,-1.0,0,1,4.5107496103686,-4.5107496103686,9.486305919587455,-9.486305919587455,8098.200099999999,-728757.0269989999,small,0.40551181102362205,Q2,192.06571428571425,800.8967857940494,1344.4599999999998,-245.67,2000.0,4.169910224594519,336.64142857142855,1008.513940614202,4712.98,-450.0,2750.0,2.9958105420771632,362.8476666666666,1055.8537892990335,10885.429999999998,-450.0,3850.0,2.9099092712893295,401.76912087912086,1133.588586806076,91.0,-0.41737886999045154,0.41737886999045154,-491.75912087912087,491.75912087912087,36560.98999999999,57079.00999999999,36560.98999999999,19,3,0,0,5,3.937007874015748,88,69.29133858267717,99,77.95275590551181,100,78.74015748031496,0,1,0,0,0,0,0,0,0,0,0,0,1,1,0,0,0,0,-175.0,175.0,-68.9,68.9,2000.0,2000.0,2750.0,2750.0,1.0,1.0,7.0,30.0,1344.4599999999998,10885.429999999998,1,3,42,1,1,-823.98,4,-10.544999999999996,5.50392857142859,0.0,989.89,0.0,209,0
2024-11-05,Expense,Home Office Supplies,-123.89,home_office,credit_car,paid,Amazon,https://tmsappstorage.blob.core.windows.net/receipts/22110099-8877-6655-4433-221100998877.png,2024,11,4,5,1,310,45,0,0,0,0,0,20032,91,31,-0.5000000000000004,0.8660254037844384,0.7818314824680298,0.6234898018587336,-0.8136678304455991,0.5813300798152042,1,3,Fall,0,0,1,0,123.89,-1.0,0,1,4.827433349874994,-4.827433349874994,11.130588483993108,-11.130588483993108,15348.7321,-1901554.419869,small,0.4566929133858268,Q2,209.46285714285713,791.0658214020358,1466.24,-175.0,2000.0,3.7766400792600465,336.7914285714286,1008.4399922031675,4715.08,-450.0,2750.0,2.9942567020802078,370.25100000000003,1051.4818434340086,11107.53,-450.0,3850.0,2.839916282289605,396.0554347826087,1128.674179094549,92.0,-0.44731556187900695,0.44731556187900695,-519.9454347826087,519.9454347826087,36437.09999999999,57202.89999999999,36437.09999999999,8,2,0,0,3,2.3622047244094486,1,0.7874015748031495,99,77.95275590551181,100,78.74015748031496,0,1,0,0,0,0,0,0,0,0,0,0,0,0,0,0,0,1,-89.99,89.99,-175.0,175.0,-68.9,68.9,-245.67,245.67,1.0,1.0,7.0,30.0,1466.24,11107.53,1,1,42,-1,1,-237.87,3,25.55500000000003,-90.88214285714287,123.89,1362.79,0.0,88,8
2024-11-06,Income,Database Design,1950.0,Unknown,Unknown,received,DataFlow Ltd,Unknown,2024,11,4,6,2,311,45,0,0,0,0,0,20033,92,30,-0.5000000000000004,0.8660254037844384,0.9749279121818236,-0.22252093395631434,-0.8035476485339116,0.5952404359043674,1,4,Fall,0,0,1,0,1950.0,1.0,1,0,7.576097340623111,7.576097340623111,44.15880433163923,44.15880433163923,3802500.0,7414875000.0,xlarge,0.8543307086614174,Q4,492.31857142857143,1013.803990907983,3446.23,-175.0,2000.0,2.059243850919956,356.4342857142857,1038.7345763343621,4990.08,-450.0,2750.0,2.9142386632440904,440.25100000000003,1085.0195254094078,13207.53,-450.0,3850.0,2.4645475544846183,412.76451612903224,1134.0298015700241,93.0,1.3841123419781076,1.3841123419781076,1537.2354838709678,1537.2354838709678,38387.09999999999,59152.89999999999,38387.09999999999,0,0,1,1,27,21.25984251968504,27,21.25984251968504,27,21.25984251968504,27,21.25984251968504,0,0,1,1,0,0,0,0,0,0,0,0,0,0,1,0,0,0,-123.89,123.89,-89.99,89.99,-175.0,175.0,-29.99,29.99,1.0,1.0,7.0,30.0,3446.23,13207.53,1,1,5,5,5,48770.0,20,1019.9950000000002,61.39642857142856,3900.0,21450.0,0.0,0,0
2024-11-07,Expense,Client Meeting Lunch,-55.25,meals_entertainment,credit_card,paid,Panera Bread,https://tmsappstorage.blob.core.windows.net/receipts/55443322-1100-9988-7766-554433221100.png,2024,11,4,7,3,312,45,0,0,0,0,0,20034,93,29,-0.5000000000000004,0.8660254037844384,0.43388373911755823,-0.900968867902419,-0.7931896839451843,0.6089746507720486,1,5,Fall,0,0,1,0,55.25,-1.0,0,1,4.029806041084529,-4.029806041084529,7.433034373659253,-7.433034373659253,3052.5625,-168654.078125,small,0.2204724409448819,Q1,490.99571428571426,1014.6291740147758,3436.97,-175.0,2000.0,2.066472566854942,365.23785714285714,1034.3652078536534,5113.33,-450.0,2750.0,2.832031750337089,368.4093333333333,1041.82650436934,11052.279999999999,-450.0,3850.0,2.827904751877459,407.7856382978723,1128.9488771834065,94.0,-0.3867003839666045,0.3867003839666045,-463.0356382978723,463.0356382978723,38331.84999999999,59208.14999999999,38331.84999999999,10,3,0,0,9,7.086614173228346,88,69.29133858267717,99,77.95275590551181,100,78.74015748031496,0,1,0,0,0,0,1,0,0,0,0,0,0,1,0,0,0,0,1950.0,1950.0,-123.89,123.89,-89.99,89.99,-45.99,45.99,1.0,1.0,7.0,30.0,3436.97,11052.279999999999,1,1,18,3,2,-511.77,7,34.319999999999915,-74.17285714285715,165.75,607.75,0.0,110,30
2024-11-08,Expense,Vehicle Insurance,-156.78,vehicle,bank_transfer,paid,Geico,Unknown,2024,11,4,8,4,313,45,0,0,0,0,0,20035,94,28,-0.5000000000000004,0.8660254037844384,-0.433883739117558,-0.9009688679024191,-0.7825970017677834,0.6225286602431057,1,6,Fall,0,0,1,0,156.78,-1.0,0,1,5.061201657666944,-5.061201657666944,12.521182052825523,-12.521182052825523,24579.9684,-3853647.445752,small,0.547244094488189,Q3,182.8842857142857,780.47261743248,1280.19,-175.0,1950.0,4.267576158247885,386.1821428571429,1019.4491943365869,5406.55,-289.0,2750.0,2.639814432625651,363.683,1043.9452709137126,10910.49,-450.0,3850.0,2.870481355778831,401.8428421052632,1124.420687816017,95.0,-0.47636033462869976,0.47636033462869976,-558.6228421052632,558.6228421052632,38175.06999999999,59364.929999999986,38175.06999999999,21,1,0,0,2,1.574803149606299,10,7.874015748031496,99,77.95275590551181,100,78.74015748031496,0,1,0,0,0,0,0,0,0,0,0,0,0,0,0,1,0,0,-55.25,55.25,1950.0,1950.0,-123.89,123.89,2000.0,2000.0,1.0,1.0,7.0,30.0,1280.19,10910.49,1,1,85,14,1,-469.23,2,-1053.3899999999999,71.99464285714286,627.12,1724.58,0.0,231,84
2024-11-09,Expense,Office Supplies,-67.45,office_supplies,credit_card,paid,Office Depot,https://tmsappstorage.blob.core.windows.net/receipts/88776655-4433-2211-0099-887766554433.png,2024,11,4,9,5,314,45,1,0,0,0,0,20036,95,27,-0.5000000000000004,0.8660254037844384,-0.9749279121818236,-0.2225209339563146,-0.7717727365467837,0.6358984534680745,0,7,Fall,0,0,1,0,67.45,-1.0,0,1,4.226103551734458,-4.226103551734458,8.212794895770866,-8.212794895770866,4549.5025000000005,-306863.943625,small,0.2559055118110236,Q1,183.0914285714286,780.3948431281141,1281.64,-175.0,1950.0,4.262323196761023,402.00714285714287,1009.8363060069042,5628.1,-245.67,2750.0,2.511985978233624,364.60133333333334,1043.5399039070994,10938.04,-450.0,3850.0,2.8621395713686346,396.954375,1119.5121055209838,96.0,-0.3974740606934592,0.3974740606934592,-464.404375,464.404375,38107.619999999995,59432.37999999998,38107.619999999995,11,3,0,0,6,4.724409448818897,88,69.29133858267717,99,77.95275590551181,100,78.74015748031496,0,1,0,0,0,0,0,1,0,0,0,0,0,1,0,0,0,0,-156.78,156.78,-55.25,55.25,1950.0,1950.0,-68.9,68.9,1.0,1.0,7.0,30.0,1281.64,10938.04,1,1,41,2,1,-505.12,5,-6.100000000000012,9.203928571428586,337.25,741.95,67.45,121,55
2024-11-10,Expense,Software License,-199.0,software,credit_card,paid,JetBrains,https://tmsappstorage.blob.core.windows.net/receipts/11009988-7766-5544-3322-110099887766.png,2024,11,4,10,6,315,45,1,0,0,0,0,20037,96,26,-0.5000000000000004,0.8660254037844384,-0.7818314824680299,0.6234898018587334,-0.7607200913564104,0.6490800741100398,0,7,Fall,0,0,1,0,199.0,-1.0,0,1,5.298317366548036,-5.298317366548036,14.106735979665885,-14.106735979665885,39601.0,-7880599.0,small,0.6377952755905512,Q3,179.66285714285715,782.2807221987584,1257.64,-199.0,1950.0,4.354159421926234,388.7207142857143,1016.9152938286094,5442.09,-245.67,2750.0,2.616056352173619,358.8013333333334,1046.2599806197493,10764.04,-450.0,3850.0,2.9159868802598723,390.81051546391757,1115.3087148570974,97.0,-0.5136443208096676,0.5136443208096676,-589.8105154639176,589.8105154639176,37908.619999999995,59631.37999999998,37908.619999999995,16,3,0,0,15,11.811023622047244,88,69.29133858267717,99,77.95275590551181,100,78.74015748031496,0,1,0,0,1,0,0,0,0,0,0,0,0,1,0,0,0,0,-67.45,67.45,-156.78,156.78,-55.25,55.25,-175.0,175.0,1.0,1.0,7.0,30.0,1257.64,10764.04,1,2,11,1,1,-1076.9099999999999,12,-21.11000000000001,-82.89035714285716,1194.0,2189.0,199.0,176,96
2024-11-11,Income,E-commerce Website,3200.0,Unknown,Unknown,received,RetailCorp,Unknown,2024,11,4,11,0,316,46,0,0,0,0,0,20038,97,25,-0.5000000000000004,0.8660254037844384,0.0,1.0,-0.7494423368521953,0.6620696215153815,1,7,Fall,0,0,1,0,3200.0,1.0,1,0,8.071218539969863,8.071218539969863,56.568542494923804,56.568542494923804,10240000.0,32768000000.0,xlarge,0.9606299212598425,Q4,649.6614285714286,1364.747349211917,4547.63,-199.0,3200.0,2.1007055201244205,420.86357142857145,1100.9333230743332,5892.09,-245.67,3200.0,2.6158912241735384,466.13433333333336,1164.5400789202624,13984.03,-450.0,3850.0,2.498292864618273,419.47571428571433,1145.2578983441185,98.0,2.4879726623525698,2.4879726623525698,2780.5242857142857,2780.5242857142857,41108.619999999995,62831.37999999998,41108.619999999995,0,0,1,1,27,21.25984251968504,27,21.25984251968504,27,21.25984251968504,27,21.25984251968504,0,0,1,1,0,0,0,0,0,0,0,0,0,0,1,0,0,0,-199.0,199.0,-67.45,67.45,-156.78,156.78,-89.99,89.99,1.0,1.0,7.0,30.0,4547.63,13984.03,1,1,5,5,5,51970.0,21,1633.7250000000001,202.19535714285718,0.0,35200.0,0.0,0,0
2024-11-12,Expense,Restaurant Meal,-42.5,food,credit_card,paid,Olive Garden,https://tmsappstorage.blob.core.windows.net/receipts/44332211-0099-8877-6655-443322110099.png,2024,11,4,12,1,317,46,0,0,0,0,0,20039,98,24,-0.5000000000000004,0.8660254037844384,0.7818314824680298,0.6234898018587336,-0.7379428103031386,0.6748632518680403,1,8,Fall,0,0,1,0,42.5,-1.0,0,1,3.7727609380946383,-3.7727609380946383,6.519202405202649,-6.519202405202649,1806.25,-76765.625,micro,0.15748031496062992,Q1,661.2885714285715,1357.3854316593183,4629.02,-199.0,3200.0,2.052637063917466,435.3757142857143,1092.7803188882247,6095.26,-199.0,3200.0,2.5099707747389193,336.38433333333336,976.1211843035134,10091.53,-450.0,3200.0,2.9018033468765787,414.80929292929295,1140.3453835823855,99.0,-0.37544100869878494,0.37544100869878494,-457.30929292929295,457.30929292929295,41066.119999999995,62873.87999999998,41066.119999999995,4,3,0,0,3,2.3622047244094486,88,69.29133858267717,99,77.95275590551181,100,78.74015748031496,0,1,0,0,0,0,0,0,0,0,0,0,0,1,0,0,0,0,3200.0,3200.0,-199.0,199.0,-67.45,67.45,-123.89,123.89,1.0,1.0,7.0,30.0,4629.02,10091.53,1,1,29,2,12,-199.28,2,78.25000000000009,17.52785714285713,42.5,467.5,0.0,44,4
2024-11-13,Expense,Fuel for Travel,-75.6,fuel,credit_card,paid,BP,https://tmsappstorage.blob.core.windows.net/receipts/77665544-3322-1100-9988-776655443322.png,2024,11,4,13,2,318,46,0,0,0,0,0,20040,99,23,-0.5000000000000004,0.8660254037844384,0.9749279121818236,-0.22252093395631434,-0.7262249146041543,0.6874571793269664,1,9,Fall,0,0,1,0,75.6,-1.0,0,1,4.338597076746545,-4.338597076746545,8.694826047713663,-8.694826047713663,5715.359999999999,-432081.2159999999,small,0.30708661417322836,Q2,371.9171428571429,1248.4021864863146,2603.42,-199.0,3200.0,3.3566675009810947,432.11785714285713,1094.3412866348028,6049.65,-199.0,3200.0,2.5325065107712414,339.0903333333333,974.8185469543004,10172.71,-450.0,3200.0,2.8748048856822823,409.90520000000004,1135.6308283869314,100.0,-0.40467122998230076,0.40467122998230076,-485.50520000000006,485.50520000000006,40990.52,62949.47999999998,40990.52,5,3,0,0,9,7.086614173228346,88,69.29133858267717,99,77.95275590551181,100,78.74015748031496,0,1,0,0,0,1,0,0,0,0,0,0,0,1,0,0,0,0,-42.5,42.5,3200.0,3200.0,-199.0,199.0,1950.0,1950.0,1.0,1.0,7.0,30.0,2603.42,10172.71,1,2,11,1,3,-770.62,8,-1637.8000000000006,122.67714285714285,151.2,831.5999999999999,0.0,55,10
2024-11-14,Expense,Business Insurance,-245.0,other,bank_transfer,paid,State Farm,Unknown,2024,11,4,14,3,319,46,0,0,0,0,0,20041,100,22,-0.5000000000000004,0.8660254037844384,0.43388373911755823,-0.900968867902419,-0.7142921172691032,0.699847677146407,1,10,Fall,0,0,1,0,245.0,-1.0,0,1,5.5053315359323625,-5.5053315359323625,15.652475842498529,-15.652475842498529,60025.0,-14706125.0,medium,0.6535433070866141,Q3,344.81,1261.2176344178938,2413.67,-245.0,3200.0,3.657717683413746,417.9028571428571,1102.293050993306,5850.639999999999,-245.0,3200.0,2.637677709431154,333.3353333333333,977.8362734743994,10000.06,-450.0,3200.0,2.9334912194758815,403.42099009900994,1131.8159511956924,101.0,-0.5542663805994478,0.5542663805994478,-648.4209900990099,648.4209900990099,40745.52,63194.47999999998,40745.52,12,1,0,0,4,3.149606299212598,10,7.874015748031496,99,77.95275590551181,100,78.74015748031496,0,1,0,0,0,0,0,0,0,0,0,0,0,0,0,1,0,0,-75.6,75.6,-42.5,42.5,3200.0,3200.0,-55.25,55.25,1.0,1.0,7.0,30.0,2413.67,10000.06,1,1,34,6,16,-604.0,4,-101.25000000000004,-4.444999999999982,735.0,2695.0,0.0,132,36
2024-11-15,Expense,Cloud Storage Service,-9.99,software,credit_card,paid,Dropbox,https://tmsappstorage.blob.core.windows.net/receipts/00998877-6655-4433-2211-009988776655.png,2024,11,4,15,4,320,46,0,0,0,0,0,20042,101,21,-0.5000000000000004,0.8660254037844384,-0.433883739117558,-0.9009688679024191,-0.7021479494046978,0.7120310787787131,1,11,Fall,0,0,1,0,9.99,-1.0,0,1,2.3969857684155302,-2.3969857684155302,3.1606961258558215,-3.1606961258558215,99.8001,-997.002999,micro,0.007874015748031496,Q1,365.78000000000003,1252.6792522296632,2560.46,-245.0,3200.0,3.4246794582253353,274.33214285714286,1007.1717767031413,3840.65,-245.0,3200.0,3.6713589819025367,335.83566666666667,976.825079413009,10075.07,-450.0,3200.0,2.9086400771796392,399.3679411764706,1126.9426255519038,102.0,-0.34673180948648596,0.34673180948648596,-409.3579411764706,409.3579411764706,40735.53,63204.46999999998,40735.53,16,3,0,0,15,11.811023622047244,88,69.29133858267717,99,77.95275590551181,100,78.74015748031496,0,1,0,0,1,0,0,0,0,0,0,0,0,1,0,0,0,0,-245.0,245.0,-75.6,75.6,-42.5,42.5,-156.78,156.78,1.0,1.0,7.0,30.0,2560.46,10075.07,1,1,5,2,3,-1086.8999999999999,13,32.804999999999986,-114.11499999999998,39.96,109.89,0.0,176,64
2024-11-16,Income,Logo Design Project,750.0,Unknown,Unknown,received,Local Business,Unknown,2024,11,4,16,5,321,46,1,0,0,0,0,20043,102,20,-0.5000000000000004,0.8660254037844384,-0.9749279121818236,-0.2225209339563146,-0.6897960046655887,0.7240037789593305,0,12,Fall,0,0,1,0,750.0,1.0,1,0,6.621405651764134,6.621405651764134,27.386127875258307,27.386127875258307,562500.0,421875000.0,large,0.7716535433070866,Q4,482.5585714285714,1243.6309732717957,3377.91,-245.0,3200.0,2.5771606741750284,332.825,1009.4814604519261,4659.55,-245.0,3200.0,3.0330698128203295,364.1356666666667,976.0909577340789,10924.07,-450.0,3200.0,2.6805694884802427,402.7721359223301,1121.9368626757423,103.0,0.324406434418624,0.324406434418624,347.2278640776699,347.2278640776699,41485.53,63954.46999999998,41485.53,0,0,1,1,27,21.25984251968504,27,21.25984251968504,27,21.25984251968504,27,21.25984251968504,0,0,1,1,0,0,0,0,0,0,0,0,0,0,1,0,0,0,-9.99,9.99,-245.0,245.0,-75.6,75.6,-67.45,67.45,1.0,1.0,7.0,30.0,3377.91,10924.07,1,1,5,5,-1,52720.0,22,497.50000000000006,-134.83857142857144,3750.0,8250.0,750.0,0,0
2024-11-17,Expense,Grocery Store,-89.23,food,credit_card,paid,Whole Foods,https://tmsappstorage.blob.core.windows.net/receipts/33221100-9988-7766-5544-332211009988.png,2024,11,4,17,6,322,46,1,0,0,0,0,20044,103,19,-0.5000000000000004,0.8660254037844384,-0.7818314824680299,0.6234898018587334,-0.6772399381909491,0.7357622347736527,0,12,Fall,0,0,1,0,89.23,-1.0,0,1,4.50236196600641,-4.50236196600641,9.446163242290492,-9.446163242290492,7961.992900000001,-710448.6264670001,small,0.3661417322834646,Q2,498.23999999999995,1234.2613661484622,3487.68,-245.0,3200.0,2.4772426263416474,338.9514285714286,1006.4180724641312,4745.320000000001,-245.0,3200.0,2.969210298672763,313.66133333333335,958.3306376292329,9409.84,-450.0,3200.0,3.055303717053317,398.0413461538462,1117.5191645966922,104.0,-0.4167077229156639,0.4167077229156639,-487.2713461538462,487.2713461538462,41396.299999999996,64043.69999999998,41396.299999999996,4,3,0,0,3,2.3622047244094486,88,69.29133858267717,99,77.95275590551181,100,78.74015748031496,0,1,0,0,0,0,0,0,0,0,0,0,0,1,0,0,0,0,750.0,750.0,-9.99,9.99,-245.0,245.0,-199.0,199.0,1.0,1.0,7.0,30.0,3487.68,9409.84,1,1,5,2,4,-288.51,3,-39.62000000000002,-293.4671428571429,535.38,981.5300000000001,89.23,44,24
2024-11-18,Expense,Parking Fees,-25.0,travel,credit_card,paid,City Parking,https://tmsappstorage.blob.core.windows.net/receipts/66554433-2211-0099-8877-665544332211.png,2024,11,4,18,0,323,47,0,0,0,0,0,20045,104,18,-0.5000000000000004,0.8660254037844384,0.0,1.0,-0.6644834655228552,0.7473029667054297,1,12,Fall,0,0,1,0,25.0,-1.0,0,1,3.258096538021482,-3.258096538021482,5.0,-5.0,625.0,-15625.0,micro,0.09055118110236221,Q1,37.52571428571428,323.7478824567649,262.67999999999995,-245.0,750.0,8.62736096085486,343.59357142857147,1004.4353015853628,4810.31,-245.0,3200.0,2.923323906815793,313.32800000000003,958.450628535811,9399.84,-450.0,3200.0,3.0589370517024044,394.01238095238097,1112.8995183040524,105.0,-0.3599869642135425,0.3599869642135425,-419.01238095238097,419.01238095238097,41371.299999999996,64068.69999999998,41371.299999999996,20,3,0,0,6,4.724409448818897,88,69.29133858267717,99,77.95275590551181,100,78.74015748031496,0,1,0,0,0,0,0,0,1,0,0,0,0,1,0,0,0,0,-89.23,89.23,750.0,750.0,-9.99,9.99,3200.0,3200.0,1.0,1.0,7.0,30.0,262.67999999999995,9399.84,1,2,20,1,3,-529.67,6,-387.5,36.43714285714285,0.0,275.0,0.0,220,0
2024-11-19,Expense,Equipment Repair,-150.0,repairs,credit_card,paid,Tech Repair Co,https://tmsappstorage.blob.core.windows.net/receipts/99887766-5544-3322-1100-998877665544.png,2024,11,4,19,1,324,47,0,0,0,0,0,20046,105,17,-0.5000000000000004,0.8660254037844384,0.7818314824680298,0.6234898018587336,-0.6515303615068021,0.75862255966641,1,13,Fall,0,0,1,0,150.0,-1.0,0,1,5.017279836814924,-5.017279836814924,12.24744871391589,-12.24744871391589,22500.0,-3375000.0,small,0.5236220472440944,Q3,22.168571428571422,330.6526460617247,155.17999999999995,-245.0,750.0,14.915379059363794,341.72857142857146,1005.3938610151907,4784.200000000001,-245.0,3200.0,2.9420831182251304,310.94300000000004,959.5475370594716,9328.29,-450.0,3200.0,3.085927443484727,388.8801886792453,1108.8469885855316,106.0,-0.4703729962509887,0.4703729962509887,-538.8801886792453,538.8801886792453,41221.299999999996,64218.69999999998,41221.299999999996,15,3,0,0,3,2.3622047244094486,88,69.29133858267717,99,77.95275590551181,100,78.74015748031496,0,1,0,0,0,0,0,0,0,0,0,0,0,1,0,0,0,0,-25.0,25.0,-89.23,89.23,750.0,750.0,-42.5,42.5,1.0,1.0,7.0,30.0,155.17999999999995,9328.29,1,3,34,1,2,-410.0,3,-30.385,4.912857142857148,150.0,1650.0,0.0,165,15
2024-11-20,Expense,Mobile Phone Bill,-65.0,telephone,credit_card,paid,Verizon,https://tmsappstorage.blob.core.windows.net/receipts/22110099-8877-6655-4433-221100998877.png,2024,11,4,20,2,325,47,0,0,0,0,0,20047,106,16,-0.5000000000000004,0.8660254037844384,0.9749279121818236,-0.22252093395631434,-0.6383844591746642,0.769717664006921,1,14,Fall,0,0,1,0,65.0,-1.0,0,1,4.189654742026425,-4.189654742026425,8.06225774829855,-8.06225774829855,4225.0,-274625.0,small,0.2440944881889764,Q1,23.682857142857134,330.1541682666004,165.77999999999994,-245.0,750.0,13.940639268103531,197.8,895.6945597347687,2769.2000000000003,-245.0,3200.0,4.528283921813795,310.27633333333335,959.810275560905,9308.29,-450.0,3200.0,3.0934047249094245,384.63831775700936,1104.4761182556838,107.0,-0.3953104944655253,0.3953104944655253,-449.63831775700936,449.63831775700936,41156.299999999996,64283.69999999998,41156.299999999996,18,3,0,0,6,4.724409448818897,88,69.29133858267717,99,77.95275590551181,100,78.74015748031496,0,1,0,0,0,0,0,0,0,1,0,0,0,1,0,0,0,0,-150.0,150.0,-25.0,25.0,-89.23,89.23,-75.6,75.6,1.0,1.0,7.0,30.0,165.77999999999994,9308.29,1,4,30,1,1,-425.65,5,-20.00000000000001,-18.39357142857142,130.0,715.0,0.0,198,36
2024-11-21,Income,Web Development Retainer,1500.0,Unknown,Unknown,received,StartupXYZ,Unknown,2024,11,4,21,3,326,47,0,0,0,0,0,20048,107,15,-0.5000000000000004,0.8660254037844384,0.43388373911755823,-0.900968867902419,-0.6250496486104377,0.7805849965070866,1,15,Fall,0,0,1,0,1500.0,1.0,1,0,7.313886831633462,7.313886831633462,38.72983346207417,38.72983346207417,2250000.0,3375000000.0,xlarge,0.8188976377952756,Q4,272.9685714285714,622.6728549949968,1910.78,-150.0,1500.0,2.281115557502684,308.8892857142857,956.291418501416,4324.45,-245.0,3200.0,3.095903492703078,364.476,980.0215191254563,10934.28,-450.0,3200.0,2.688850621509938,394.9657407407408,1104.52961792234,108.0,0.9867226266433012,0.9867226266433012,1105.0342592592592,1105.0342592592592,42656.299999999996,65783.69999999998,42656.299999999996,0,0,1,1,27,21.25984251968504,27,21.25984251968504,27,21.25984251968504,27,21.25984251968504,0,0,1,1,0,0,0,0,0,0,0,0,0,0,1,0,0,0,-65.0,65.0,-150.0,150.0,-25.0,25.0,-245.0,245.0,1.0,1.0,7.0,30.0,1910.78,10934.28,1,1,5,5,10,54220.0,23,825.0000000000001,101.39999999999999,4500.0,16500.0,0.0,0,0
2024-11-22,Expense,Client Entertainment,-125.45,entertainment,credit_card,paid,Theater District,https://tmsappstorage.blob.core.windows.net/receipts/55443322-1100-9988-7766-554433221100.png,2024,11,4,22,4,327,47,0,0,0,0,0,20049,108,14,-0.5000000000000004,0.8660254037844384,-0.433883739117558,-0.9009688679024191,-0.6115298757991053,0.7912213413483807,1,16,Fall,0,0,1,0,125.45,-1.0,0,1,4.839846973115974,-4.839846973115974,11.200446419674531,-11.200446419674531,15737.702500000001,-1974294.778625,small,0.47244094488188976,Q2,256.4742857142857,632.8633713490134,1795.32,-150.0,1500.0,2.4675509655343304,311.1271428571429,955.1538426905863,4355.780000000001,-245.0,3200.0,3.0699791536000913,304.461,951.7193784585086,9133.83,-450.0,3200.0,3.125915563761889,390.1912844036697,1100.5336048591435,109.0,-0.44869317955883425,0.44869317955883425,-515.6412844036697,515.6412844036697,42530.85,65909.14999999998,42530.85,3,3,0,0,4,3.149606299212598,88,69.29133858267717,99,77.95275590551181,100,78.74015748031496,0,1,0,0,0,0,0,0,0,0,0,0,0,1,0,0,0,0,1500.0,1500.0,-65.0,65.0,-150.0,150.0,-9.99,9.99,1.0,1.0,7.0,30.0,1795.32,9133.83,1,1,43,2,2,-452.73,4,-30.225000000000005,18.289642857142862,501.8,1379.95,0.0,33,12
2024-11-23,Expense,Office Rent,-1200.0,rent,bank_transfer,paid,Property Management,Unknown,2024,11,4,23,5,328,47,1,0,0,0,0,20050,109,13,-0.5000000000000004,0.8660254037844384,-0.9749279121818236,-0.2225209339563146,-0.5978291414589552,0.801623551065242,0,17,Fall,0,0,1,0,1200.0,-1.0,0,1,7.0909098220799835,-7.0909098220799835,34.64101615137755,-34.64101615137755,1440000.0,-1728000000.0,xlarge,0.7834645669291339,Q4,-22.097142857142867,789.2646059616576,-154.68000000000006,-1200.0,1500.0,35.71794829151539,230.23071428571433,1034.3600979978974,3223.2300000000005,-1200.0,3200.0,4.492711153709341,270.411,987.2059663981324,8112.33,-1200.0,3200.0,3.650761124355638,375.735,1105.9162639359608,110.0,-1.3976156653655367,1.3976156653655367,-1575.7350000000001,1575.7350000000001,41330.85,67109.14999999998,41330.85,14,1,0,0,2,1.574803149606299,10,7.874015748031496,99,77.95275590551181,100,78.74015748031496,0,1,0,0,0,0,0,0,0,0,0,0,0,0,0,1,0,0,-125.45,125.45,1500.0,1500.0,-65.0,65.0,750.0,750.0,1.0,1.0,7.0,30.0,-154.68000000000006,8112.33,1,1,65,9,2,-2400.0,2,-1350.0,-67.25749999999998,6000.0,13200.0,1200.0,154,70
2024-11-24,Expense,Training Course,-299.0,training,credit_card,paid,Udemy,https://tmsappstorage.blob.core.windows.net/receipts/88776655-4433-2211-0099-887766554433.png,2024,11,4,24,6,329,47,1,0,0,0,0,20051,110,12,-0.5000000000000004,0.8660254037844384,-0.7818314824680299,0.6234898018587334,-0.5839514998576998,0.8117885474764613,0,17,Fall,0,0,1,0,299.0,-1.0,0,1,5.703782474656201,-5.703782474656201,17.291616465790582,-17.291616465790582,89401.0,-26730899.0,medium,0.6968503937007874,Q3,-52.064285714285724,796.1902906520353,-364.45000000000005,-1200.0,1500.0,15.292446246574965,223.0878571428572,1037.8914430204416,3123.2300000000005,-1200.0,3200.0,4.652388777735286,275.4443333333333,983.7852623016649,8263.33,-1200.0,3200.0,3.5716300654881206,369.6563063063063,1102.73915625915,111.0,-0.6019531464396246,0.6019531464396246,-668.6563063063063,668.6563063063063,41031.85,67408.14999999998,41031.85,19,3,0,0,5,3.937007874015748,88,69.29133858267717,99,77.95275590551181,100,78.74015748031496,0,1,0,0,0,0,0,0,0,0,0,0,1,1,0,0,0,0,-1200.0,1200.0,-125.45,125.45,1500.0,1500.0,-89.23,89.23,1.0,1.0,7.0,30.0,-364.45000000000005,8263.33,1,1,20,2,10,-1122.98,5,-86.77500000000006,-106.51607142857142,1794.0,3289.0,299.0,209,114
2024-11-25,Expense,Hardware Components,-165.99,hardware,credit_card,paid,Best Buy,https://tmsappstorage.blob.core.windows.net/receipts/ccddaabb-9988-7766-5544-332211009988.png,2024,11,4,25,0,330,48,0,0,0,0,0,20052,111,11,-0.5000000000000004,0.8660254037844384,0.0,1.0,-0.5699010576127624,0.821713322596059,1,17,Fall,0,0,1,0,165.99,-1.0,0,1,5.117933930384341,-5.117933930384341,12.88371064561759,-12.88371064561759,27552.6801,-4573469.369799001,small,0.5669291338582677,Q3,-72.2057142857143,797.1742517972921,-505.44000000000005,-1200.0,1500.0,11.040320834482914,-17.339999999999982,587.2976134020062,-242.75999999999976,-1200.0,1500.0,33.86952787785506,279.54466666666667,981.6055164977691,8386.34,-1200.0,3200.0,3.5114442647129827,364.87375000000003,1098.9268161658963,112.0,-0.48449357746921884,0.48449357746921884,-530.86375,530.86375,40865.86,67574.13999999998,40865.86,7,3,0,0,2,1.574803149606299,88,69.29133858267717,99,77.95275590551181,100,78.74015748031496,0,1,0,0,0,0,0,0,0,0,0,0,0,1,0,0,0,0,-299.0,299.0,-1200.0,1200.0,-125.45,125.45,-25.0,25.0,1.0,1.0,7.0,30.0,-505.44000000000005,8386.34,1,2,99,1,3,-400.98,2,517.0049999999999,-114.8560714285714,0.0,1825.89,0.0,77,0
2024-11-26,Income,Consulting Services,2200.0,Unknown,Unknown,received,TechStart Inc,Unknown,2024,11,4,26,1,331,48,0,0,0,0,0,20053,112,10,-0.5000000000000004,0.8660254037844384,0.7818314824680298,0.6234898018587336,-0.5556819724760489,0.8313949395234058,1,18,Fall,0,0,1,0,2200.0,1.0,1,0,7.696667081526462,7.696667081526462,46.9041575982343,46.9041575982343,4840000.0,10648000000.0,xlarge,0.905511811023622,Q4,263.50857142857143,1167.6799655788768,1844.56,-1200.0,2200.0,4.431278873580766,142.83857142857144,833.9296931613981,1999.7400000000002,-1200.0,2200.0,5.838266826817272,353.311,1040.2629029219097,10599.33,-1200.0,3200.0,2.944326394937915,381.1138053097345,1107.5469280232703,113.0,1.6048844060529999,1.6048844060529999,1818.8861946902655,1818.8861946902655,43065.86,69774.13999999998,43065.86,0,0,1,1,27,21.25984251968504,27,21.25984251968504,27,21.25984251968504,27,21.25984251968504,0,0,1,1,0,0,0,0,0,0,0,0,0,0,1,0,0,0,-165.99,165.99,-299.0,299.0,-1200.0,1200.0,-150.0,150.0,1.0,1.0,7.0,30.0,1844.56,10599.33,1,1,5,5,3,56420.0,24,1249.5000000000002,117.48107142857143,2200.0,24200.0,0.0,0,0
2024-11-27,Expense,Coffee Shop Meeting,-18.75,meals_entertainment,credit_card,paid,Starbucks,https://tmsappstorage.blob.core.windows.net/receipts/00112233-4455-6677-8899-aabbccddeeff.png,2024,11,4,27,2,332,48,0,0,0,0,0,20054,113,9,-0.5000000000000004,0.8660254037844384,0.9749279121818236,-0.22252093395631434,-0.5412984521036173,0.8408305333122887,1,19,Fall,0,0,1,0,18.75,-1.0,0,1,2.9831534913471307,-2.9831534913471307,4.330127018922194,-4.330127018922194,351.5625,-6591.796875,micro,0.06299212598425197,Q1,270.11571428571426,1165.6404142052438,1890.81,-1200.0,2200.0,4.3153372890119615,146.89928571428572,832.9220175933388,2056.59,-1200.0,2200.0,5.670020882289004,261.01933333333335,938.1022475995173,7830.58,-1200.0,3200.0,3.593995263184275,377.60622807017546,1103.271204634614,114.0,-0.3544676626116702,0.3544676626116702,-396.35622807017546,396.35622807017546,43047.11,69792.88999999998,43047.11,10,3,0,0,9,7.086614173228346,88,69.29133858267717,99,77.95275590551181,100,78.74015748031496,0,1,0,0,0,0,1,0,0,0,0,0,0,1,0,0,0,0,2200.0,2200.0,-165.99,165.99,-299.0,299.0,-65.0,65.0,1.0,1.0,7.0,30.0,1890.81,7830.58,1,1,20,2,9,-530.52,8,73.62000000000005,40.309285714285686,37.5,206.25,0.0,110,20
2024-11-28,Expense,Vehicle Maintenance,-285.5,vehicle_expenses,credit_card,paid,AutoShop Pro,https://tmsappstorage.blob.core.windows.net/receipts/ffeeddcc-bbaa-9988-7766-554433221100.png,2024,11,4,28,3,333,48,0,0,0,0,0,20055,114,8,-0.5000000000000004,0.8660254037844384,0.43388373911755823,-0.900968867902419,-0.5267547528105542,0.8500173118187018,1,20,Fall,0,0,1,0,285.5,-1.0,0,1,5.6577385361547945,-5.6577385361547945,16.896745248715803,-16.896745248715803,81510.25,-23271176.375,medium,0.6771653543307087,Q3,15.044285714285706,1040.269907393544,105.30999999999995,-1200.0,2200.0,69.14717834730615,144.0064285714286,834.4567586861723,2016.0900000000001,-1200.0,2200.0,5.794579915383942,259.69166666666666,938.8719460592739,7790.75,-1200.0,3200.0,3.615333360944481,371.84008695652176,1100.16074170805,115.0,-0.5900314549795804,0.5900314549795804,-657.3400869565218,657.3400869565218,42761.61,70078.38999999998,42761.61,22,3,0,0,3,2.3622047244094486,88,69.29133858267717,99,77.95275590551181,100,78.74015748031496,0,1,0,0,0,0,0,0,0,0,0,0,0,1,0,0,0,0,-18.75,18.75,2200.0,2200.0,-165.99,165.99,1500.0,1500.0,1.0,1.0,7.0,30.0,105.30999999999995,7790.75,1,2,64,1,4,-526.49,3,-1242.7499999999998,156.47678571428568,856.5,3140.5,0.0,242,66
2024-11-29,Expense,Printer Paper & Supplies,-45.67,office_supplies,credit_card,paid,Staples,https://tmsappstorage.blob.core.windows.net/receipts/aabbccdd-eeff-1122-3344-556677889900.png,2024,11,4,29,4,334,48,0,0,0,0,0,20056,115,7,-0.5000000000000004,0.8660254037844384,-0.433883739117558,-0.9009688679024191,-0.5120551783114646,0.8589525565270845,1,21,Fall,0,0,1,0,45.67,-1.0,0,1,3.8431015599617244,-3.8431015599617244,6.757958271549182,-6.757958271549182,2085.7489,-95256.15226300001,micro,0.18503937007874016,Q1,26.44142857142856,1038.9102622047233,185.08999999999992,-1200.0,2200.0,39.29100348713094,141.45785714285714,835.0175669287862,1980.41,-1200.0,2200.0,5.9029422882145655,259.169,939.0431205601694,7775.07,-1200.0,3200.0,3.6232848857701714,368.24086206896555,1096.0527158296318,116.0,-0.3782403984712546,0.3782403984712546,-413.91086206896557,413.91086206896557,42715.94,70124.05999999998,42715.94,11,3,0,0,6,4.724409448818897,88,69.29133858267717,99,77.95275590551181,100,78.74015748031496,0,1,0,0,0,0,0,1,0,0,0,0,0,1,0,0,0,0,-285.5,285.5,-18.75,18.75,2200.0,2200.0,-125.45,125.45,1.0,1.0,7.0,30.0,185.08999999999992,7775.07,1,3,20,1,2,-550.79,6,-13.460000000000003,129.90107142857144,182.68,502.37,0.0,121,44
2024-11-30,Expense,Legal Consultation,-350.0,professional_fees,credit_card,paid,Johnson Law,https://tmsappstorage.blob.core.windows.net/receipts/11223344-5566-7788-9900-aabbccddeeff.png,2024,11,4,30,5,335,48,1,0,1,0,0,20057,116,6,-0.5000000000000004,0.8660254037844384,-0.9749279121818236,-0.2225209339563146,-0.4972040784469378,0.8676336233547726,0,22,Fall,0,0,1,0,350.0,-1.0,0,1,5.860786223465865,-5.860786223465865,18.708286933869708,-18.708286933869708,122500.0,-42875000.0,medium,0.7244094488188977,Q3,147.86999999999998,913.8145766693233,1035.09,-350.0,2200.0,6.179851062888506,62.886428571428596,825.0447585211281,880.4100000000003,-1200.0,2200.0,13.119599526693005,249.0353333333333,944.0766626736724,7471.0599999999995,-1200.0,3200.0,3.7909346036854443,362.1020512820513,1093.3363590922042,117.0,-0.6469906475109026,0.6469906475109026,-712.1020512820513,712.1020512820513,42365.94,70474.05999999998,42365.94,13,3,0,0,3,2.3622047244094486,88,69.29133858267717,99,77.95275590551181,100,78.74015748031496,0,1,0,0,0,0,0,0,0,0,0,0,0,1,0,0,0,0,-45.67,45.67,-285.5,285.5,-18.75,18.75,-1200.0,1200.0,1.0,1.0,7.0,30.0,1035.09,7471.0599999999995,1,4,36,1,2,-995.0,3,-32.250000000000036,-85.63785714285713,1750.0,3850.0,350.0,143,65
2024-12-01,Income,Freelance Design Project,1850.0,Unknown,Unknown,received,Creative Studio,Unknown,2024,12,4,1,6,336,48,1,1,0,0,0,20058,117,5,-2.4492935982947064e-16,1.0,-0.7818314824680299,0.6234898018587334,-0.4822058478963526,0.8760579434344281,0,1,Winter,0,0,0,1,1850.0,1.0,1,0,7.523481312573497,7.523481312573497,43.01162633521314,43.01162633521314,3422500.0,6331625000.0,xlarge,0.8346456692913385,Q4,454.87,1083.8321843655815,3184.09,-350.0,2200.0,2.3827295367150647,201.40285714285716,950.75295634103,2819.6400000000003,-1200.0,2200.0,4.720652774387659,244.0353333333333,934.8354493807198,7321.0599999999995,-1200.0,3200.0,3.8307381009610078,374.7113559322034,1097.236889647479,118.0,1.2958035163481505,1.2958035163481505,1475.2886440677967,1475.2886440677967,44215.94,72324.05999999998,44215.94,0,0,1,1,27,21.25984251968504,27,21.25984251968504,27,21.25984251968504,27,21.25984251968504,0,0,1,1,0,0,0,0,0,0,0,0,0,0,1,0,0,0,-350.0,350.0,-45.67,45.67,-285.5,285.5,-299.0,299.0,1.0,1.0,7.0,30.0,3184.09,7321.0599999999995,1,1,5,5,5,58270.0,25,947.8350000000002,32.89464285714288,11100.0,22200.0,1850.0,0,0
2024-12-02,Expense,Internet Service,-79.99,telephone,credit_card,paid,Comcast,https://tmsappstorage.blob.core.windows.net/receipts/fedcba09-8765-4321-fedc-ba0987654321.png,2024,12,4,2,0,337,49,0,0,0,0,0,20059,118,4,-2.4492935982947064e-16,1.0,0.0,1.0,-0.46706492487743034,0.8842230238742036,1,1,Winter,0,0,0,1,79.99,-1.0,0,1,4.3943256902608985,-4.3943256902608985,8.94371287553441,-8.94371287553441,6398.400099999999,-511808.0239989999,small,0.3425196850393701,Q2,467.1557142857142,1076.0812184164226,3270.0899999999997,-350.0,2200.0,2.3034743780492155,197.47500000000005,951.8731769657776,2764.6500000000005,-1200.0,2200.0,4.8202211771909225,243.66566666666668,934.96564567786,7309.97,-1200.0,3200.0,3.8370840605824372,370.8903361344538,1093.3725021754688,119.0,-0.40854798742745585,0.40854798742745585,-450.8803361344538,450.8803361344538,44135.950000000004,72404.04999999999,44135.950000000004,18,3,0,0,6,4.724409448818897,88,69.29133858267717,99,77.95275590551181,100,78.74015748031496,0,1,0,0,0,0,0,0,0,1,0,0,0,1,0,0,0,0,1850.0,1850.0,-350.0,350.0,-45.67,45.67,-165.99,165.99,1.0,1.0,7.0,30.0,3270.0899999999997,7309.97,1,1,12,2,7,-505.64,6,135.00499999999997,-113.10607142857148,0.0,959.8799999999999,0.0,216,0
2024-12-02,Expense,Home Office Desk,-435.0,furniture,credit_card,paid,IKEA,https://tmsappstorage.blob.core.windows.net/receipts/98765432-10ab-cdef-9876-543210abcdef.png,2024,12,4,2,0,337,49,0,0,0,0,0,20059,118,4,-2.4492935982947064e-16,1.0,0.0,1.0,-0.46706492487743034,0.8842230238742036,1,1,Winter,0,0,0,1,435.0,-1.0,0,1,6.077642243349034,-6.077642243349034,20.85665361461421,-20.85665361461421,189225.0,-82312875.0,medium,0.7480314960629921,Q3,90.72714285714281,792.3541990321063,635.0899999999997,-435.0,1850.0,8.733375416436642,177.1178571428572,962.8602043125994,2479.6500000000005,-1200.0,2200.0,5.436268368671541,234.999,940.1708357723603,7049.97,-1200.0,3200.0,4.000743985175938,364.1745833333333,1091.2514273217505,120.0,-0.722053149296366,0.722053149296366,-799.1745833333333,799.1745833333333,43700.950000000004,72839.04999999999,43700.950000000004,6,3,0,0,1,0.7874015748031495,88,69.29133858267717,99,77.95275590551181,100,78.74015748031496,0,1,0,0,0,0,0,0,0,0,0,0,0,1,0,0,0,0,-79.99,79.99,1850.0,1850.0,-350.0,350.0,2200.0,2200.0,0.0,0.0,7.0,30.0,635.0899999999997,7049.97,1,2,-1,0,2,-435.0,1,-1142.5000000000002,37.78357142857139,0.0,5220.0,0.0,72,0
2024-12-03,Expense,Business Lunch,-67.89,meals_entertainment,credit_card,paid,Restaurant ABC,https://tmsappstorage.blob.core.windows.net/receipts/abcdef12-3456-7890-abcd-ef1234567890.png,2024,12,4,3,1,338,49,0,0,0,0,0,20060,119,3,-2.4492935982947064e-16,1.0,0.7818314824680298,0.6234898018587336,-0.451785789832884,0.8921264484954345,1,2,Winter,0,0,0,1,67.89,-1.0,0,1,4.232511029605105,-4.232511029605105,8.239538822045807,-8.239538822045807,4609.0521,-312908.547069,small,0.2677165354330709,Q2,83.70714285714281,793.7023214806737,585.9499999999997,-435.0,1850.0,9.481894786867,176.9114285714286,962.9164132735759,2476.76,-1200.0,2200.0,5.4429293859033825,235.73566666666665,939.9160349244835,7072.07,-1200.0,3200.0,3.987160908720432,360.60380165289257,1087.4046649172333,121.0,-0.39786261952623103,0.39786261952623103,-428.49380165289256,428.49380165289256,43633.060000000005,72906.93999999999,43633.060000000005,10,3,0,0,9,7.086614173228346,88,69.29133858267717,99,77.95275590551181,100,78.74015748031496,0,1,0,0,0,0,1,0,0,0,0,0,0,1,0,0,0,0,-435.0,435.0,-79.99,79.99,1850.0,1850.0,-18.75,18.75,1.0,1.0,7.0,30.0,585.9499999999997,7072.07,1,3,6,1,1,-598.41,9,6.050000000000001,5.1492857142857265,67.89,814.6800000000001,0.0,120,10
2024-12-03,Expense,Fuel for Vehicle,-89.45,fuel,credit_card,paid,Shell,https://tmsappstorage.blob.core.windows.net/receipts/12345678-9abc-def0-1234-56789abcdef0.png,2024,12,4,3,1,338,49,0,0,0,0,0,20060,119,3,-2.4492935982947064e-16,1.0,0.7818314824680298,0.6234898018587336,-0.451785789832884,0.8921264484954345,1,2,Winter,0,0,0,1,89.45,-1.0,0,1,4.504797211841304,-4.504797211841304,9.457801012920498,-9.457801012920498,8001.302500000001,-715716.508625,small,0.3858267716535433,Q2,111.71428571428567,781.8737038008372,781.9999999999997,-435.0,1850.0,6.998869471362996,63.379285714285736,885.5087900659516,887.3100000000003,-1200.0,2200.0,13.971580463336736,236.88366666666667,939.4825793304547,7106.51,-1200.0,3200.0,3.9660082628341673,356.91483606557375,1083.6682302569154,122.0,-0.41690200233204977,0.41690200233204977,-446.36483606557374,446.36483606557374,43543.61000000001,72996.38999999998,43543.61000000001,5,3,0,0,9,7.086614173228346,88,69.29133858267717,99,77.95275590551181,100,78.74015748031496,0,1,0,0,0,1,0,0,0,0,0,0,0,1,0,0,0,0,-67.89,67.89,-435.0,435.0,-79.99,79.99,-285.5,285.5,0.0,0.0,7.0,30.0,781.9999999999997,7106.51,1,4,20,0,0,-860.0699999999999,9,172.775,-66.14714285714284,89.45,1073.4,0.0,60,5
2024-12-04,Expense,Adobe Creative Suite,-52.99,software,credit_card,paid,Adobe,https://tmsappstorage.blob.core.windows.net/receipts/f9e8d7c6-b5a4-3210-9876-543210fedcba.png,2024,12,4,4,2,339,49,0,0,0,0,0,20061,120,2,-2.4492935982947064e-16,1.0,0.9749279121818236,-0.22252093395631434,-0.4363729641045924,0.8997658785476209,1,3,Winter,0,0,0,1,52.99,-1.0,0,1,3.9887988442301956,-3.9887988442301956,7.2794230540613585,-7.2794230540613585,2807.9401000000003,-148792.74589900003,small,0.2125984251968504,Q1,110.66857142857137,782.1241339972534,774.6799999999996,-435.0,1850.0,7.067265113312305,68.55500000000002,884.5314232775364,959.7700000000003,-1200.0,2200.0,12.902507815294816,170.11733333333333,883.0145244673112,5103.52,-1200.0,3200.0,5.190620539161076,353.58227642276427,1079.8505238384246,123.0,-0.38470460450736743,0.38470460450736743,-406.5722764227643,406.5722764227643,43490.62000000001,73049.37999999999,43490.62000000001,16,3,0,0,15,11.811023622047244,88,69.29133858267717,99,77.95275590551181,100,78.74015748031496,0,1,0,0,1,0,0,0,0,0,0,0,0,1,0,0,0,0,-89.45,89.45,-67.89,67.89,-435.0,435.0,-45.67,45.67,1.0,1.0,7.0,30.0,774.6799999999996,5103.52,1,5,19,1,1,-1139.8899999999999,14,7.449999999999985,-106.27750000000005,105.98,635.88,0.0,192,32
2024-12-04,Income,Client Payment - Mobile App,2850.0,Unknown,Unknown,received,TechCorp,Unknown,2024,12,4,4,2,339,49,0,0,0,0,0,20061,120,2,-2.4492935982947064e-16,1.0,0.9749279121818236,-0.22252093395631434,-0.4363729641045924,0.8997658785476209,1,3,Winter,0,0,0,1,2850.0,1.0,1,0,7.955425088912672,7.955425088912672,53.38539126015655,53.38539126015655,8122500.0,23149125000.0,xlarge,0.9448818897637795,Q4,567.8114285714285,1258.2509663474482,3974.6799999999994,-435.0,2850.0,2.2159662575181245,357.84071428571434,1078.7009017650262,5009.77,-435.0,2850.0,3.014472246173051,266.959,1007.92303144618,8008.77,-1200.0,3200.0,3.7755723966833106,373.71467741935487,1098.569858696515,124.0,2.1788917726477206,2.1788917726477206,2476.2853225806452,2476.2853225806452,46340.62000000001,75899.37999999999,46340.62000000001,0,0,1,1,27,21.25984251968504,27,21.25984251968504,27,21.25984251968504,27,21.25984251968504,0,0,1,1,0,0,0,0,0,0,0,0,0,0,1,0,0,0,-52.99,52.99,-89.45,89.45,-67.89,67.89,-350.0,350.0,0.0,0.0,7.0,30.0,3974.6799999999994,8008.77,1,1,3,3,3,61120.0,26,1469.7250000000004,121.41249999999995,5700.0,34200.0,0.0,0,0
2024-12-05,Expense,Office365 Subscription,-15.99,software,credit_card,paid,Microsoft,https://tmsappstorage.blob.core.windows.net/receipts/a1b2c3d4-e5f6-7890-1234-56789abcdef0.png,2024,12,4,5,3,340,49,0,0,0,0,0,20062,121,1,-2.4492935982947064e-16,1.0,0.43388373911755823,-0.900968867902419,-0.42083100859565564,0.9071390534005044,1,4,Winter,0,0,0,1,15.99,-1.0,0,1,2.8326249356838407,-2.8326249356838407,3.998749804626441,-3.998749804626441,255.6801,-4088.324799,micro,0.051181102362204724,Q1,301.2414285714285,1132.7380240583523,2108.6899999999996,-435.0,2850.0,3.7602332103858167,378.0557142857143,1068.043930706355,5292.780000000001,-435.0,2850.0,2.8250966467317684,271.652,1006.2083309218591,8149.5599999999995,-1200.0,3200.0,3.7040343193566003,370.59704,1094.6862494731186,125.0,-0.3520303390242834,0.3520303390242834,-386.58704,386.58704,46324.63000000001,75915.37,46324.63000000001,16,3,0,0,15,11.811023622047244,88,69.29133858267717,99,77.95275590551181,100,78.74015748031496,0,1,0,0,1,0,0,0,0,0,0,0,0,1,0,0,0,0,2850.0,2850.0,-52.99,52.99,-89.45,89.45,1850.0,1850.0,1.0,1.0,7.0,30.0,2108.6899999999996,8149.5599999999995,1,1,1,1,6,-1155.8799999999999,15,18.499999999999957,242.03214285714287,47.97,191.88,0.0,192,48
2024-12-06,Expense,Neptune HX100G,-1295.83,computer_equipment,credit_card,paid,Minisforum,https://tmsappstorage.blob.core.windows.net/receipts/de9d50f5-6c8a-4a92-b9a1-b379034d8fdd.png,2024,12,4,6,4,341,49,0,0,0,0,0,20063,122,0,-2.4492935982947064e-16,1.0,-0.433883739117558,-0.9009688679024191,-0.4051645224207563,0.9142437912130223,1,5,Winter,0,0,0,1,1295.83,-1.0,0,1,7.167678104021865,-7.167678104021865,35.997638811455396,-35.997638811455396,1679175.3889,-2175925844.1982865,xlarge,0.7952755905511811,Q4,127.54999999999988,1284.0490220522481,892.8499999999992,-1295.83,2850.0,10.067024869088588,297.3528571428572,1151.7230644054655,4162.9400000000005,-1295.83,2850.0,3.873253734542538,230.70600000000002,1044.739092288531,6921.18,-1295.83,3200.0,4.528443526776638,357.37142857142857,1100.3593946581013,126.0,-1.4822420129667244,1.4822420129667244,-1653.2014285714286,1653.2014285714286,45028.80000000001,77211.2,45028.80000000001,2,3,0,0,5,3.937007874015748,88,69.29133858267717,99,77.95275590551181,100,78.74015748031496,0,1,0,0,0,0,0,0,0,0,1,0,0,1,0,0,0,0,-15.99,15.99,2850.0,2850.0,-52.99,52.99,-79.99,79.99,1.0,1.0,7.0,30.0,892.8499999999992,6921.18,1,2,45,1,2,-1993.79,5,-2072.9150000000004,16.455714285714322,5183.32,15549.96,0.0,24,8
2024-12-06,Income,Daniel Howard - Web Development,3567.18,Unknown,Unknown,received,Unknown,Unknown,2024,12,4,6,4,341,49,0,0,0,0,0,20063,122,0,-2.4492935982947064e-16,1.0,-0.433883739117558,-0.9009688679024191,-0.4051645224207563,0.9142437912130223,1,5,Winter,0,0,0,1,3567.18,1.0,1,0,8.179810940857914,8.179810940857914,59.725873790175726,59.725873790175726,12724773.152399998,45391556293.77823,xlarge,0.984251968503937,Q4,699.2899999999998,1785.0806231745767,4895.029999999999,-1295.83,3567.18,2.5527043475161624,395.00857142857143,1363.8815839803976,5530.12,-1295.83,3567.18,3.452789844655372,356.24533333333335,1205.2689088639202,10687.36,-1295.83,3567.18,3.3832552909153994,382.64551181102365,1132.3896483351837,127.0,2.8122250083006453,2.8122250083006453,3184.534488188976,3184.534488188976,48595.98000000001,80778.37999999999,48595.98000000001,0,0,1,1,27,21.25984251968504,27,21.25984251968504,27,21.25984251968504,27,21.25984251968504,0,0,1,1,0,0,0,0,0,0,0,0,0,0,1,0,0,0,-1295.83,1295.83,-15.99,15.99,2850.0,2850.0,-435.0,435.0,0.0,0.0,7.0,30.0,4895.029999999999,10687.36,1,1,2,2,0,64687.18,27,1791.585,304.62321428571425,14268.72,42806.159999999996,0.0,0,0
